data,type,description,paid in,paid out,balance,embeddings
22-Oct-14,auto,54656815,,190.0,1803,"[-0.08304872, -0.033558466, -0.039948, 0.017615568, -0.1042361, -0.024727367, -0.027062243, 0.03175112, 0.050829258, -0.075084254, -0.0653023, 0.0079721045, -0.047068655, -0.08400967, -0.038318697, 0.01758142, -0.0057701496, -0.062376577, -0.023377152, -0.006345985, -0.007769723, -0.001968513, -0.07160767, -0.056880526, -0.07111374, -0.04686882, -0.032648373, 0.06684806, -0.019666906, -0.031045161, 0.11474545, 0.049832307, 0.067281626, 0.0026108013, 0.04710951, 0.04994334, -0.03863311, 0.012489372, -0.006756183, 0.0006449307, -0.007228003, 0.007116668, -0.004584167, 0.0079349475, 0.077692464, 0.0452711, -0.009773246, 0.09911214, -0.03560104, 0.03696347, -0.05312855, 0.06364657, 0.04465209, 0.022140767, 0.01629235, -0.030390467, 0.051386327, 0.015393113, 0.016069876, -0.0020743604, 0.08158241, 0.023297055, -0.007047721, -0.066024326, 0.03645699, -0.010372769, 0.034251936, -0.08327527, 0.031109758, -0.051033918, -0.072812356, 0.07895275, 0.06621206, -0.010030649, 0.04359483, -0.0025215836, -0.07979308, 0.011482643, 0.064894296, 0.06850984, -0.012084514, -0.009674962, -0.17318216, 0.09762477, -0.012636236, -0.027379079, 0.021188436, 0.05602867, 0.033530798, 0.08726245, -0.000566612, 0.04351963, -0.051536046, -0.006005603, -0.074936286, 0.058699023, 0.114421144, -0.07483541, -0.048216123, 0.07179983, 0.046181016, 0.0019066759, -0.054420065, -0.016029863, -0.039385103, 0.004068618, 0.018287381, 0.020238018, 0.034672704, -0.02162468, 0.014838922, -0.020573132, -0.029582847, 0.0027499252, 0.06254349, 0.04052819, 0.014695788, 0.01328887, 0.052929025, -0.04370991, 0.04816289, -0.027840309, 0.019446332, -0.043538317, -0.046888333, -0.028782701, -0.005120418, 1.1021307e-33, -0.014418813, 0.017164415, 0.11579357, 0.019827694, -0.037849125, -0.086407445, 0.035935156, -0.021885239, 0.021538207, 0.026494753, -0.055044107, -0.02472499, 0.053410485, -0.05248811, -0.03796114, -0.016206166, 0.05888674, 0.035012756, -0.029466372, 0.018043065, 0.05308844, -0.003145723, 0.003129399, 0.031467468, 0.08594492, 0.15159234, 0.0006188169, -0.019944683, 0.09640678, 0.05210265, 0.012535365, -0.05855922, 0.04306297, 0.005214284, 0.032478917, -0.038735237, -0.05387146, -0.05054687, -0.018336674, -0.025868181, 0.020380085, 0.009696731, -0.038390964, 0.047026444, -0.0078018378, 0.055230096, 0.0809591, 0.052331507, 0.07846046, -0.02123409, -0.11142352, 0.001066555, -0.056913417, -0.013570333, -0.049735207, -0.05804949, 0.0041303122, -0.04352007, -0.017574668, -0.035505645, 0.02861924, 0.16393082, -0.031929005, -0.002191667, 0.022135537, -0.10037781, 0.051309105, 0.0042456863, 0.0748802, -0.031409882, -0.050848246, -0.020010343, 0.026697965, 0.033068422, -0.07563484, -0.060945164, -0.05226224, 0.018688947, -0.0057966993, 0.14766608, -0.0028625345, 0.013960697, -0.1439432, -0.050057027, -0.04968347, 0.09847131, -0.01464724, 0.003489256, 0.06937479, 0.0060817646, -0.028749295, -0.07515849, 0.07306879, -0.011084168, -0.015485193, -1.9220277e-33, -0.04381991, -0.042625017, -0.023768295, -0.023308607, -0.088209674, -0.038134333, -0.002651389, 0.01297111, -0.01033957, 0.0156311, -0.031269375, -0.0419254, 0.037379768, -0.02110615, -0.019693341, 0.06681642, -0.025829827, 0.037488144, -0.037419908, 0.026284946, -0.020923829, 0.0050446214, -0.058130756, 0.034306534, -0.012172445, 0.005031885, 0.043727852, 0.050104473, 0.036655508, -0.074856125, -0.016686913, 0.008038387, 0.027445866, 0.05468444, -0.04067141, -0.09193574, 0.11438605, 0.08586834, -0.042557273, 0.0093827555, 0.072148874, 0.03450319, 0.007229195, 0.14255543, -0.014517095, 0.057801403, -0.056989748, -0.07101115, 0.027016025, -0.013657104, 0.021798005, 0.07148347, -0.07175766, 0.043641057, 0.06316491, -0.020926962, 0.07504926, 0.05169656, 0.022853713, -0.032132804, 0.008051146, 0.015875567, 0.059025813, 0.09423717, 0.107460335, -0.013058895, -0.005593152, -0.021315683, 0.0228896, -0.015309784, -0.04946775, -0.041778684, 0.009858957, 0.016422449, -0.01657289, 0.038396705, 0.0011798133, 0.088348165, 0.00074510224, 0.10758521, 0.057671506, 0.0021131716, 0.03895839, -0.06828408, -0.036683783, -0.03559449, 0.13632046, 0.08616543, -0.045371674, -0.013707416, -0.031720202, 0.0039344276, -0.113797225, -0.11747095, -0.074393325, -1.4932104e-08, 0.037418745, -0.036163636, 0.026529044, -0.049387228, 0.053226333, 0.040293064, -0.011659485, 0.043990478, 0.0037307278, -0.02467944, 0.04916818, 0.0037540987, -0.021343224, -0.017457308, 0.008268265, -0.11715749, -0.09325318, -0.023198146, 0.011445883, 0.025896413, -0.036698584, -0.015160032, -0.008980579, -0.010078819, 0.01620815, -0.06820073, 0.02364364, 0.01755323, -0.096929125, -0.028545866, 0.0039505586, 0.044928744, -0.07579365, -0.021723175, -0.02982545, 0.024548195, -0.059994992, -0.02473, 0.009896111, -0.008468074, 0.039550986, -0.051841743, -0.009913878, -0.010520414, 0.018731643, -0.012938417, 0.01169341, -0.08681487, -0.027862702, -0.0118395435, -0.08368953, -0.046818543, 0.053788222, -0.06258438, 0.033954695, 0.039993513, -0.024863036, -0.017420761, -0.047531128, 0.01858126, 0.011868257, 0.083641924, -0.041532014, -0.043617263]"
22-Oct-14,dig bank,from ac 545,,140.0,1613,"[-0.073149405, 0.056251213, -0.09191843, 0.06320529, 0.03300745, 0.052323572, 0.035339274, 0.0038431706, -0.02362796, -0.021609195, 0.027244149, 0.015599326, -0.006061024, -0.043172415, -0.0011469205, 0.05619923, 0.01837493, -0.017329887, -0.023550833, -0.063317426, -0.05492033, 0.07588324, -0.056150846, -0.049500197, -0.01458955, 0.023512492, -0.06278882, 0.057546854, -0.02125929, -0.089968786, -0.024610566, -0.019046798, -0.0033014785, -0.0043402184, -0.013337447, -0.0014096113, -0.0058490266, 0.022131782, 0.105635, 0.0119479885, 0.0210058, -0.057313446, -0.0018672951, 0.105199344, 0.029190823, 0.021482235, -0.018849175, 0.056431066, 0.07616908, 0.049233854, -0.067297764, 0.07669126, 0.011553787, -0.03148997, -0.031899232, -0.01686656, 0.048823867, 0.0025795389, 0.020639027, -0.0725072, -0.05792028, -0.01994163, -0.053704023, -0.000995637, 0.01416492, -0.043566603, 0.050750274, -0.058000665, 0.019041564, -0.10430022, -0.041718204, 0.02022498, 0.074652106, -0.052333362, 0.12918425, 0.0372168, -0.007328532, -0.08523226, 0.04068667, 0.0067851515, 0.047869846, 0.045198422, -0.09974292, 0.06883277, 0.02779537, -0.022049107, 0.01088223, 0.06098548, -0.014596329, -0.04243871, -0.056819852, 0.0049952893, -0.074835934, 0.071629964, -0.052428562, 0.03785525, 0.032981843, -0.056445368, -0.04420568, 0.11828761, 0.05837221, 0.02806458, -0.04695079, -0.076999456, -0.09534716, -0.01763566, -0.027497478, 0.088252984, -0.03088453, -0.042160198, -0.060690165, -0.011886004, -0.14871019, -0.09293781, 0.09104604, -0.013182679, -0.11308111, 0.03758613, 0.02384035, -0.06042438, -0.06133675, 0.0070797955, -0.009989475, 0.028958088, -0.058554754, -0.003812625, 0.008510146, -1.6138913e-33, -0.0033099267, 0.035900187, 0.053606655, 0.07556128, 0.0051895827, -0.03384236, -0.023474758, -0.0022168183, 0.018716216, 0.08320563, -0.08433017, -0.0073539317, -0.024186144, -0.13372774, 0.06907929, -0.05344654, 0.003937288, 0.019308733, -0.0018759284, 0.004648524, -0.013195686, 0.09488269, 0.004611537, -0.000702155, 0.071370564, 0.15043944, -0.056208305, -0.012865524, 0.059845135, 0.056349702, -0.012444381, 0.049702685, 0.012709851, -0.030118637, 0.018595552, 0.032443233, -0.12390604, -0.049251083, -0.060698003, 0.015594888, 0.06063725, 0.072415076, -0.029673753, 0.031911105, 0.030353421, -0.00027824615, -0.068302386, 0.02583005, 0.061862238, 0.007963315, -0.07847772, -0.00022076699, 0.012118734, 0.019918002, -0.026466038, -0.06973667, -0.036761977, 0.0054567866, 0.046092194, 0.037588343, 0.048598163, 0.12918904, 0.0037052145, -0.0040125824, -0.07276317, 0.006720817, -0.0009750351, -0.02260143, 0.011818551, 0.023717834, 0.013427873, -0.030671066, 0.064031065, -0.024946066, 0.058534183, -0.03487401, -0.03175717, 0.07054774, 0.03694125, -0.06776077, -0.0558053, -0.028158383, -0.07302482, 0.023593692, 0.019349586, 0.076396674, -0.016487492, -0.0029698578, 0.04374998, 0.035583973, 0.051316634, -0.02275182, 0.077738136, -0.04283962, 0.012697373, 1.2794324e-33, -0.0021404575, -0.06248099, 0.007275096, -0.055444516, 0.009292334, -0.009277899, -0.051301103, 0.029636411, -0.023370283, 0.07839964, 0.022253776, 0.00552265, 0.08853136, -0.012648583, 0.035976455, 0.005351721, 0.059820507, 0.01877807, 0.061207343, 0.07252425, 0.025505692, 0.002060032, -0.0034119375, -0.012250185, 0.0081183715, 0.09261026, 0.045833666, 0.06368619, 0.051327895, -0.028235056, -0.09628334, 0.0154983075, 0.0016306635, 0.013766721, -0.081244364, -0.041239463, 0.0046447986, 0.11298695, -0.06248742, 0.0060308534, 0.031978432, 0.025196442, 0.037108004, 0.15231164, -0.023935094, -0.021664444, 0.037924457, -0.04405455, 0.07963994, 0.06818034, -0.023264501, -0.006621095, -0.05192698, 0.035802174, -0.020162093, 0.0033096576, 0.0072544916, 0.0208291, 0.019144446, -0.032622218, -0.032298997, 0.018130632, -0.041419927, 0.04259246, 0.13650008, 0.020014903, 0.06391348, 0.02459665, -0.04314081, -0.0061875205, -0.027549954, 0.014205235, -0.024555879, -0.019524967, -0.060957, 0.008283624, -0.012849615, 0.098776504, -0.0028468932, 0.029584164, -0.08778935, -0.040816333, -0.05853735, 0.06181726, -0.02926513, -0.06905808, 0.10701129, -0.004005743, 0.056808643, 0.02374256, 0.0035372148, 0.03699998, -0.014636724, -0.016704248, -0.055188674, -1.5327045e-08, -0.056466494, 0.12109733, 0.061415914, 0.034742262, 0.016012847, 0.10055427, 0.012271343, -0.05355695, 0.011318707, 0.032593295, 0.05822516, 0.017608946, 0.0897674, -0.026633264, 0.053872284, -0.11256097, -0.08739054, 0.011746168, 0.02069697, 0.014803852, -0.107208945, -0.061822694, 0.095254764, -0.024963437, 0.012096134, -0.0045909067, -0.0054253573, -0.02971597, 0.027293557, -0.029481875, -0.087763876, 0.019594902, -0.023185758, -0.081649534, 0.0059729856, -0.0009549429, 0.0187024, -0.07433245, -0.027277, -0.05538691, 0.054815687, -0.060062192, -0.05299187, 0.023724273, -0.0049228286, -0.027472176, 0.0041735256, -0.09538002, -0.033124555, 0.0031036043, -0.019146645, 0.020854693, -0.012082022, -0.026121452, 0.0030894373, 0.0005028352, -0.029818764, -0.0518874, -0.06861251, -0.004151734, -0.005438838, -0.042811316, 0.010604886, 0.059060536]"
24-Oct-14,faster,amazon,,132.0,1473,"[-0.023181891, -0.026144285, -0.06706474, 0.03212099, 0.024532262, -0.02530872, -0.0016351461, -0.035979837, 0.10757465, 0.04946225, 0.015323343, 0.0379587, 0.04780176, -0.025319524, -0.0020937365, -0.004514993, -0.021283755, -0.022373997, -0.03305866, -0.083913825, -0.035260364, 0.09358925, 0.008363277, 0.04334779, -0.06311475, 0.0437161, -0.06682711, -0.006024506, 0.030478772, -0.16666752, -0.019889258, -0.0057974737, 0.04501139, 0.0507394, 0.013982519, -0.07530377, -0.026490327, -0.041904088, 0.025924576, 0.033148635, 0.03985482, -0.034091394, -0.03297138, -0.037169088, 0.010748732, 0.016038572, 0.06710767, 0.06037689, 0.095659345, 0.056566417, 0.0051561114, 0.015575818, -0.06564956, 0.007302145, -0.026275275, -0.052234128, -0.039246734, -0.008897301, 0.032421146, -0.034951277, 0.058918506, -0.10952972, -0.0040527554, 0.040254757, 0.015233716, 0.07283245, -0.021944553, 0.08721838, -0.043541323, -0.10538219, -0.06146047, -0.04752473, -0.02784013, 0.08265346, 0.05064785, -0.018569456, 0.09052019, -0.06681275, -0.037178595, -0.0026414571, -0.062898226, -0.07380037, -0.08088983, -0.030997174, -0.0064199357, -0.03224064, 0.049077656, 0.04383965, 0.010153017, -0.013289816, -0.01084529, -0.02409563, 0.088517584, 0.08396439, -0.122394025, -0.017638244, 0.023958895, -0.052491963, 0.025752336, 0.18510012, 0.03448101, 0.0055687013, 0.01346653, -0.04374561, -0.035882104, -0.057390578, -0.03027254, 0.080805995, 0.03378727, -0.009751416, -0.08532484, 0.0146588655, -0.06373305, -0.026734049, 0.005485912, -0.016292159, -0.008136507, 0.037988428, 0.0834728, -0.019138467, 0.017024897, -0.00254599, 0.0483464, -0.0069402177, -0.04630573, -0.03349561, -0.044569362, -3.3626908e-33, 0.051649746, -0.010573003, 0.02280802, -0.13361731, 0.005156096, 0.032790165, 0.026515165, 0.018641561, -0.081830464, 0.035275232, -0.102498434, 0.059088726, -0.10459819, -0.02543372, 0.070754915, 0.05723942, 0.0017414798, 0.011591114, -0.003311955, 0.009223485, -0.035188008, 0.06127582, 0.0011498332, 0.05568315, -0.029474523, -0.05561717, -0.003772165, -0.0032042265, 0.1270439, 0.03899402, -0.009061193, 0.027505666, -0.00019385353, -0.056052774, -0.022998461, -0.06876461, -0.067228265, -0.018304039, 0.035111696, 0.003952858, 0.014466444, 0.07749672, 0.0039305924, 0.058893062, 0.017054452, 0.04021498, 0.009934153, 0.050251506, 0.08392809, 0.09272941, -0.10639584, -0.032126803, 0.03911237, -0.05527014, -0.020164892, -0.044774137, -0.036987644, -0.019316155, 0.0521394, -0.02869752, 0.06354588, 0.090869084, 0.004992143, 0.024103036, -0.016535833, -0.019162172, 0.040420804, -0.03554252, -0.040217567, 0.0044002766, -0.05208577, 0.057889014, 0.14373168, 0.006831447, -0.005946147, 0.020675436, -0.03530713, 0.022396246, -0.031485077, -0.10609074, -0.010278753, -0.01628008, -0.02283685, 0.11808659, -0.01413861, 0.0044524437, -0.03202866, 0.0041474435, 0.013282066, -0.03295956, -0.07702753, 0.024771674, 0.022484107, -0.025847096, 0.024878465, 3.2779553e-33, -0.027464533, -0.16831306, -0.04255768, 0.10516403, 0.026563834, -0.023181887, -0.014713751, 0.036582362, -0.0137197245, -0.014752024, -0.0844178, -0.03842581, 0.0760323, 0.007406198, 0.0374589, -0.043091793, 0.07419991, -0.057864536, 0.03441652, 0.006249078, -0.024077313, -0.07271696, -0.03301725, -0.04928037, 0.035735633, 0.0067557488, 0.0066971495, -0.018894717, -0.08278356, -0.026139794, -0.010406775, -0.0075877667, -0.053638186, 0.10800099, -0.11122217, 0.06109592, -0.012364166, 0.055582758, -0.004527057, -0.019527605, 0.053209092, 0.01462056, 0.03675694, 0.072526805, 0.0025025015, -0.05459385, -0.014165641, 0.052048128, 0.028144749, -0.009023855, -0.053385485, 0.04111471, 0.04744341, -0.063781366, -0.019625448, 0.029742489, -0.03256313, 0.046956755, 0.03451076, 0.0014097529, -0.07033086, 0.042069037, -0.03209223, 0.0240691, -0.069183975, 0.046001226, 0.04166175, 0.03641198, -0.015659792, 0.023531457, 0.0423064, -0.042389475, 0.013664925, -0.008558818, -0.04898023, 0.0706638, -0.0466825, -0.01714749, -0.0103166215, -0.025764544, 0.036508657, 0.0015069994, 0.08558352, 0.10316098, 0.04068374, 0.02194197, 0.010272132, 0.0072247023, 0.013072746, -0.0048573045, -0.03452636, -0.01310388, -0.018926384, 0.00013059574, -0.017433105, -1.1545225e-08, 0.041486975, -0.02398719, 0.06656005, 0.05187719, 0.07828356, 0.0038288955, 0.0302895, 0.064820476, 0.008162814, 0.07004484, -0.008237095, -0.096013024, 0.014041186, -0.004024316, -0.007612714, -0.0049880976, 0.07578472, 0.004602596, 0.03267482, 0.009432914, -0.03420473, 0.041278068, 0.13206638, -0.09351475, 0.03168956, -0.0123845665, 0.033461574, 0.020636102, 0.040876485, -0.011027255, 0.047601096, 0.015460985, 0.0029467545, -0.050432988, 0.01383401, -0.1134238, -0.06943422, -0.028018968, -0.051713333, -0.090083346, 0.01722993, 0.013900894, 0.019066349, -0.032234285, 0.10223195, -0.035930358, 0.031028481, -0.040642843, 0.043736458, 0.044582553, -0.01637449, -0.081585, 0.030668505, 0.037316177, 0.03290457, -0.038607348, 0.032883167, -0.04447913, -0.022622664, 0.11904493, 0.113903694, -0.045713298, -0.015317325, 0.07182807]"
24-Oct-14,bacs,trebay trading,,515.0,1341,"[-0.06284462, -0.015667558, -0.07668343, -0.05909815, -0.071372084, 0.015155143, 0.10228461, 0.061838094, -0.037597165, -0.00065409753, 0.026309187, 0.018994274, -0.0526193, -0.008827442, -0.03347505, -0.0066933353, -0.004464346, -0.04019088, 0.020080933, -0.049443964, -0.07067015, -0.0989393, -0.06982474, -0.051104058, 0.060636833, 0.0041669095, -0.02393878, 0.017094765, -0.00086083537, -0.06298903, -0.0717093, 0.029766656, -0.016014537, 0.064965785, -0.05338708, 0.00839883, -0.038430754, -0.000105091116, 0.03489143, -0.034058478, -0.006836205, -0.055616584, -0.057431366, -0.014784757, 0.037969254, -0.057437364, 0.042885516, 0.09721451, -0.008874668, 0.04022059, 0.083674595, 0.0012199485, -0.02760814, 0.0760383, -0.010371804, 0.053745925, -0.011683379, -0.01165127, 0.050816834, -0.0511821, 0.09365644, 0.006302233, -0.062272202, -0.009681128, 0.044312745, -0.05951116, -0.079373576, 0.09052399, -0.070217766, -0.009626561, 0.07048574, -0.01496196, -0.0577961, 0.028228862, 0.0185122, -0.084070526, 0.078870475, -0.07421029, -0.01727402, 0.02591721, -0.041363288, 0.04587339, -0.10024731, -0.066606805, 0.00081194006, -0.04256041, 0.03827426, 0.083750635, 0.048004147, -0.0464389, 0.055793017, -0.015769884, 0.029281206, -0.0017135779, -0.104915805, 0.042655278, -0.018839758, 0.026529144, 0.024525106, 0.09005111, 0.10842935, 0.04240601, -0.028288271, -0.030038947, -0.059038375, 0.011835304, -0.06869136, 0.09629501, -0.016906893, -0.018621022, -0.13262728, 0.058365043, -0.02535505, 0.024422642, -0.09172836, 0.081631295, -0.109183624, -0.005883839, 0.05452299, 0.010643112, 0.07848679, 0.061127666, -0.01062162, 0.009429862, -0.06255139, 0.018019715, 0.008494726, -1.1513397e-33, -0.034071967, 0.024618454, -0.026430888, -0.00023692474, 0.054275975, 0.03772043, 0.039520632, -0.015221193, -0.07619064, 0.094416276, -0.058891874, 0.082814395, -0.008781055, 0.022576692, 0.035339206, 0.017820299, -0.024583189, 0.002029434, 0.10724921, -0.09201867, -0.027081627, -0.0027816193, -0.017863926, 0.048064362, -0.015504684, -0.038339265, -0.042734716, -0.06311711, 0.14117627, 0.046092145, 0.024066377, 0.013243472, -0.0061710295, -0.04578486, -0.0053005894, 0.013316341, 0.013144809, -0.02590087, -0.009867979, -0.009520954, 0.015879158, 0.0313625, -0.04442544, -0.009921878, 0.0024909305, -0.009224366, 0.047217563, -0.034024425, -0.060415227, 0.04672981, -0.04767948, -0.017089222, -0.035524767, -0.020805165, -0.016196635, -0.060693458, 0.023378994, -0.04775104, -0.042005267, 0.010788547, 0.05938729, 0.010587859, 0.02335356, -0.03297829, -0.14518118, 0.044672757, 0.035900254, 0.0018592447, -0.07811261, -0.00028543425, -0.11252337, 0.026625056, 0.077946156, -0.027073693, 0.07370181, 0.035524096, 0.02859846, 0.055012077, 0.014283751, -0.07898465, -0.034229632, -0.024772113, 0.024193984, 0.10416093, -0.0014892282, 0.00024249157, -0.027616458, -0.069690354, 0.03304121, 0.034766052, -0.0892189, 0.06770074, -0.025886716, 0.009661948, 0.046848625, 1.8133281e-34, -0.08679734, -0.023781512, -0.03201467, 0.01183536, -0.008786041, -0.016531918, -0.03363875, -0.011160128, 0.019302364, 0.031346086, -0.0016243032, -0.036114562, -0.0072556227, -0.026479214, 0.021175742, -0.07423759, 0.05460467, 0.05869425, -0.026738515, -0.09358194, 0.06432681, 0.0309044, -0.009208606, 0.007875814, 0.0030965195, 0.054751165, -0.013222689, 0.030383883, 0.0012871061, 0.1066416, 0.03446665, -0.059681773, 0.098993026, 0.081658415, -0.09212127, 0.03950572, 0.08617628, 0.033444352, 0.060543068, 0.01771416, 0.08503321, -0.022002168, 0.06749065, 0.043759543, -0.051783137, -0.063147426, -0.04080582, -0.013020961, 0.13091823, 0.02852813, 0.06621784, 0.08252406, 0.023063222, -0.032838933, -0.039730057, 0.06354513, -0.0395914, -0.048167694, 0.04016406, 0.00958424, -0.024667757, 0.06649616, -0.0058589587, 0.015199032, 0.09320242, -0.023335043, 0.0147222, -0.009153648, -0.019793235, -0.035593342, -0.042841904, 0.0457327, 0.024346596, -0.075668894, 0.03782552, -0.05148805, -0.039410822, -0.0016544115, 0.04172807, 0.0019198045, -0.10610691, 0.009875525, 0.06656171, 0.06621161, -0.04048593, 0.03925315, -0.037224807, 0.0860357, 0.052820176, -0.08619951, -0.042375736, -0.025186228, 0.06564366, -0.05713431, -0.03950119, -1.2456935e-08, -0.025803426, 0.0027910287, -0.02452014, 0.015028089, -0.0045486907, 0.09371117, 0.030369923, 0.028466418, 0.00044083744, 0.015176243, -0.006962909, 0.007013566, -0.11304639, 0.022775082, -0.0024890774, -0.044669505, 0.03629379, -0.029283362, -0.005888035, -0.069880754, 0.072240144, 0.053834695, 0.10565433, 0.051721144, -0.019280234, -0.018506443, 0.0640402, 0.118581854, -0.016798401, 0.010639595, -0.030862056, 0.07451499, 0.034810476, 0.04837417, 0.067901194, -0.011500695, 0.002323219, 0.020628545, -0.091307454, -0.006969258, -0.0069211754, -0.04090024, -0.07043094, -0.0075321943, 0.017115066, 0.0053399657, 0.029079512, -0.005952993, 0.059922077, -0.07364053, -0.014119539, -0.045583714, 0.076854385, 0.004726306, -0.011912057, 0.027022287, -0.031079082, -0.05639863, 0.009269043, -0.06313145, 0.038697448, -0.09210334, -0.072228506, 0.055195805]"
25-Oct-14,faster,morrisons petrol,,80.0,825,"[-0.02805035, 0.031677008, -0.039902505, 0.06282055, 0.06160682, 0.021436077, 0.024733521, 0.056268614, -0.02583152, 0.004207546, 0.0005277279, -0.004859215, -0.039427053, 0.045645796, -0.024062373, -0.001244873, 0.038478363, -0.014792403, 0.042789433, -0.024274556, -0.060675334, 0.029598486, 0.041789453, 0.09896902, -0.057672583, 0.053767707, 0.00053094386, 0.08757869, -0.049533356, -0.122472815, -0.04127461, 0.014446938, -0.03253753, -0.059797816, 0.12701221, -0.046339158, 0.034244973, 0.048642226, 0.05255521, -0.0754928, 0.0044597466, -0.15895034, 0.022831108, -0.007960305, -0.014138933, -0.011429631, 0.057171613, 0.006919024, 0.087410755, 0.007056401, -0.0116554005, -0.005365728, -0.04686172, -0.07971643, 0.008420572, -0.022790296, -0.013335666, 0.044943474, 0.027729139, -0.071931064, 0.0701179, -0.055714082, -0.05905931, -0.019948767, 0.035462465, -0.0074710846, -0.034828786, -0.03134601, 0.047303963, -0.028299727, 0.04554826, -0.047295447, 0.020160148, -0.061218653, -0.060592074, 0.046322912, 0.09173651, -0.044557627, 0.029520644, 0.010309662, -0.036783747, -0.05434734, -0.043446273, -0.07881619, -0.026901376, -0.04455283, 0.041858826, -0.024856396, 0.01661945, -0.03146031, 0.0020197926, -0.010835836, 0.018147925, 0.0075338986, -0.062043726, -0.048765294, 0.051466934, 0.033034205, 0.009845847, 0.083479315, 0.034603473, 0.087773666, -0.0509745, -0.0028794596, -0.041085094, 0.042429812, -0.06423307, 0.038389124, 0.046652008, -0.021406563, 0.025773216, 0.069673255, -0.041533478, -0.055069838, -0.102250054, -0.027783453, 0.031553715, -0.049699076, 0.05452862, 0.116368204, 0.0050399303, 0.016202535, -0.0042370358, 0.05435937, -0.059099797, 0.0050260546, -0.00059301645, -2.566658e-33, -0.0822984, 0.049495727, 0.0616636, 0.011293166, 0.00015578543, 0.036909554, -0.030446278, -0.057332586, -0.06801168, 0.029798832, -0.031984273, 0.069628574, -0.053709053, 0.0069216494, -0.1133637, -0.019725231, -0.029375782, -0.0067593483, -0.055748682, -0.11810541, -0.11081804, 0.10937081, -0.040745668, 0.008120093, 0.07102194, 0.013773406, -0.0014951412, -0.0340041, 0.06884632, 0.05095637, 0.068923, 0.089623824, -0.07165132, 0.0007205819, -0.026679428, 0.042335697, -0.108495586, -0.0552665, 0.029784806, -0.051483344, 0.015533187, 0.020622602, -0.014168909, 0.025000634, -0.082548335, 0.048681714, -0.0076405024, 0.039007924, 0.04436616, -0.014839255, -0.026664147, -0.032096107, -0.11682062, 0.08217103, -0.011937528, -0.035722014, 0.017727913, -0.0551714, 0.073218755, -0.012573182, 0.034299932, 0.046756472, -0.07268752, 0.0016697034, -0.052648272, -0.021795841, -0.012065496, -0.054930646, -0.0039114514, 0.042512942, -0.03174554, 0.03541773, 0.16757052, -0.02780532, 0.017610155, -0.039921407, -0.032078173, 0.046815716, -0.041584115, 0.035725318, -0.012327598, -0.06088825, -0.028500626, -0.035284027, -0.023120178, -0.0068287337, -0.10652625, -0.029383933, 0.06730704, 0.0065203384, -0.09934106, -0.07507322, 0.012114293, -0.018614067, -0.031963833, 5.3428606e-34, 0.06738385, -0.02784357, 0.07840164, 0.10979837, 0.021817788, -0.03747899, 0.092728876, -0.035652652, 0.014557538, 0.06475296, 0.054385077, -0.033304907, 0.05356479, 0.013286007, -0.015348162, 0.06223231, 0.018321995, -0.044922188, 0.075642414, -0.023371758, -0.11029253, -0.001672724, -0.0495994, 0.06871267, -0.060758766, -0.019568715, -0.041257527, -0.07624931, -0.051271774, 0.050978184, -0.079331495, 0.047780737, -0.014400877, 0.0885066, -0.07294634, -0.023428718, 0.0011137471, 0.06447578, -0.04603136, 0.06392033, -0.032388903, 0.023605991, -0.024472542, 0.106400564, -0.008131154, -0.038762942, 0.055798158, 0.046291545, 0.061326567, 0.04579441, 0.04880491, -0.0073154327, -0.07087811, 0.053548433, -0.045398977, 0.025109379, -0.014798763, 0.062633574, -0.030317998, 0.037489343, 0.08033578, 0.0074043493, -0.008847746, -0.045542452, -0.01682829, 0.022502987, -0.10335048, -0.045487445, 0.10160532, 0.038483217, 0.020544868, 0.017608477, 0.103230655, -0.031519458, 0.009047159, 0.026790116, -0.013933973, -0.013044057, -0.016756576, -0.050162766, 0.028738702, -0.052971635, 0.003643181, 0.124269865, 0.07225038, 0.02999772, 0.06992828, 0.040441837, -0.03051444, 0.006568513, -0.009021854, 0.005436504, 0.01646454, 0.059533507, -0.024066757, -1.1234749e-08, 0.0070555923, 0.02163, 0.020771757, 0.03474023, -0.013469327, 0.0062655983, 0.11283071, 0.096259125, 0.019629087, 0.06758192, 0.019088486, -0.00661362, 0.032038786, -0.010592313, -0.028877664, 0.016913416, -0.042603355, 0.01692447, -0.0066399407, 0.021753196, -0.015292044, 0.05265053, 0.09065289, -0.005633178, -0.052991886, 0.023599856, 0.026284123, 0.030383216, 0.047532585, -0.042349454, -0.0151073, 0.021484803, 0.017844932, -0.0067857234, 0.02269859, -0.029313182, 0.0449117, 0.030134063, -0.069718905, -0.01576767, -0.057879426, -0.013304199, -0.054477602, -0.04271131, -0.027463067, -0.009153398, -0.084766865, 0.055441976, -0.07075571, 0.021708649, 0.03192282, 0.02340207, -0.037010558, 0.061447665, 0.037348755, -0.02012731, -0.09075298, 0.04204708, -0.06292258, -0.021545392, 0.09350946, -0.081250936, 0.052009106, -0.07543295]"
25-Oct-14,bacs,business loan,20000.0,,745,"[-0.0062298733, 0.04613635, 0.0039250776, -0.05439065, -0.09370104, -0.0023161795, 0.019185593, 0.009172665, 0.046317145, -0.10146138, -0.044228394, 0.009667206, -0.007786328, -0.058737773, -0.04457628, 0.013804353, -0.042985667, -0.051310193, -0.022572951, 0.019909533, -0.01756717, 0.005768626, -0.038517248, -0.060026217, 0.049991664, -0.027922882, 0.096091434, -0.0056321686, 0.015787175, -0.057697807, -0.014077704, 0.01801655, 0.044725534, -0.012937507, 0.06914639, 0.041550823, 0.031529587, -0.004801323, 0.027782189, 0.011693873, -0.00995247, -0.03767008, -0.008532402, -0.10870496, 0.017642729, 0.04915341, -0.048672896, -0.0077133374, 0.034745403, 0.1251871, -0.10142134, -0.023438303, -0.011477179, 0.047530994, 0.01811425, -0.009063501, -0.037484568, 0.016459757, 0.032461163, -0.07291983, 0.08846292, 0.007671521, 0.049330242, -0.027620647, 0.032179482, 0.122429885, -0.035475153, -0.02395028, -0.049721252, -0.0746025, -0.024266465, -0.0887038, -0.0070469677, -0.026450051, 0.0015427688, 0.03893966, -0.025054667, 0.016743409, 0.0072449646, -0.05133871, 0.02924236, 0.022066442, -0.057702683, -0.02176257, -0.13694826, -0.010547698, 0.018180769, 0.022011373, 0.085908085, 0.08434578, 0.048243042, 0.007783548, -0.039465565, -0.08254847, -0.10469041, 0.007781706, -0.07345317, -0.039595928, 0.02023479, 0.11625068, 0.051344313, 0.07162684, 0.078712665, 0.010768021, -0.0003870651, 0.01991009, 0.084250666, 0.017289879, 0.07605083, -0.028293908, -0.01310987, 0.050249264, 0.001022196, -0.06275442, -0.019530019, -0.058035966, -0.04227109, -0.028355105, 0.0734381, 0.012600035, 0.111121766, 0.115246505, -0.041362826, -0.046864685, -0.079122745, -0.038605522, -0.09731678, -3.5110815e-33, 0.026828129, 0.020965835, 0.046669375, -0.013575604, -0.037112158, 0.04072667, 0.007529083, 0.04503161, -0.11433267, 0.075890586, -0.04215638, -0.028636847, -0.010680556, -0.07619865, 0.008191813, 0.05907078, -0.013691162, 0.023145428, 0.05671449, 0.05820858, 0.026149737, -0.0039862846, 0.010269283, -0.026601668, 0.08736713, -0.06782934, 0.043397065, 0.06262077, 0.09213516, -0.030715417, 0.09594045, -0.02446546, 0.036014766, -0.025087493, -0.021305032, -0.00954022, -0.0019410196, -0.02995023, -0.018920232, -0.008676734, -0.0536513, 0.043850683, 0.024069985, 0.03560107, -0.008140311, -4.399166e-06, 0.02384051, -0.0065391297, -0.029403022, 0.023617, -0.057267293, -0.04275854, -0.05070495, -6.55401e-05, -0.050131075, -0.08057533, 0.0072250464, -0.048478913, -0.06926136, -0.033868972, -0.005244793, -0.06155429, 0.0041724374, 0.053335607, -0.06545315, 0.031425796, 0.01332631, 0.05777867, 0.0049469154, -0.057644963, -0.06552992, -0.078226425, 0.04695249, 0.031050805, -0.04719932, -0.0067095663, -0.012275907, 0.06375551, 0.0716572, 0.030441552, -0.01812148, -0.04746652, 0.036326155, 0.095636696, 0.022411203, 0.09524531, 0.06735997, -0.13948438, 0.0395893, -0.03550695, -0.12451182, 0.040836, -0.031684846, 0.058968347, 0.06596927, 1.4865692e-33, 0.03056256, 0.001966564, -0.033443395, 0.002468485, 0.024793455, 0.042399425, 0.040032882, -0.028173525, -0.032510854, 0.07988565, 0.033464305, -0.06673613, 0.03916278, 0.03073125, 0.022238843, -0.058309384, 0.06706731, -0.004071684, 0.008402444, 0.05056152, -0.08270341, 0.09505329, 0.111611016, -0.046062313, -0.022631666, 0.07481939, -0.06543569, 0.03578137, -0.08820073, 0.068803675, 0.0036356114, 0.07598046, -0.000766064, 0.03053294, -0.04482005, -0.011091177, -0.020079754, -0.10196092, 0.059011955, -0.0287542, 0.08773534, -0.0124068, 0.048105687, 0.018865721, 0.020037012, -0.050410934, 0.059332192, -0.10057163, 0.042268388, -0.028067503, -0.085757196, 0.016907074, -0.0005783877, 0.019628072, -0.0005155506, 0.07491235, 0.057028275, -0.0720712, 0.022177786, 0.06851265, -0.0018749522, 0.036926102, 0.10399154, 0.034769516, 0.028404083, 0.0027837583, 0.0953256, -0.013377639, 0.061695628, -0.054765396, 0.025867837, 0.030479211, 0.009595557, 0.12915662, -0.035598107, 0.05465856, 0.014519453, -0.062847905, -0.015888393, -0.012802207, -0.015994655, -0.033185583, 0.000522042, 0.07118036, 0.004963266, -0.08883546, 0.05229973, -0.067807786, -0.009876906, 0.0047358046, -0.10046199, 0.02544226, 0.011354159, 0.03946555, -0.017220048, -1.1877437e-08, -0.062312763, 0.06532241, -0.05242739, -0.011996335, 0.023192277, -0.09462425, -0.04862408, 0.0070802933, -0.04025435, -0.002144252, 0.022910478, -0.016910078, -0.06323273, 0.053480465, -0.043436456, -0.054367166, -0.030581735, -0.02792589, -0.008196288, 0.1251958, -0.0139843635, -0.009349553, 0.03406567, -0.0067609763, 0.051692013, -0.08610241, 0.009774933, 0.12728177, 0.014290501, -0.045469332, -0.016771693, 0.0832813, -0.00065443385, -0.0032439253, -0.049163416, -0.009591035, -3.3888522e-05, 0.04955633, -0.025786074, -0.014312638, -0.05361877, -0.051021114, -0.043122746, -0.042462427, 0.037542872, 0.0071496544, -0.062318128, -0.030557815, 0.018478105, 0.030431438, -0.014442793, 0.02433332, 0.056669444, -0.026467547, 0.022597877, -0.057744347, -0.005642669, 0.066468835, -0.0243862, -0.013430934, -0.008725138, -0.022463718, -0.046734408, -0.08759079]"
26-Oct-14,bacs,james white media,,2461.0,20745,"[0.014369532, -0.0126776, -0.021008098, -0.01945483, 0.07683699, 0.061452247, 0.03330612, 0.0072193323, 0.0029281178, 0.024036659, -0.026728623, 0.056773648, 0.035031807, 0.06418094, -0.05914754, 0.0139659485, 0.055541847, -0.0036926214, -0.113505185, -0.027128648, -0.027933845, 0.017425394, 0.024457045, -0.021415126, -0.014451596, -0.039276484, -9.7518525e-05, 0.025854288, 0.025456872, -0.024253774, 0.06095921, -0.07566277, 0.06291796, 0.0138983885, -0.0032932418, -0.09313131, 0.014305941, -0.03144793, -0.040562704, 0.015214904, 0.057457983, -0.025219165, 0.029659323, 0.003032898, -0.03184031, -0.025493216, 0.011407045, 0.0012247649, -0.03661138, 0.04185092, -0.04621843, -0.011457409, -0.044855073, 0.022898171, 0.052161805, -0.07077909, -0.09952746, 0.10049, 0.06701853, -0.02163274, -0.03540212, -0.07540038, -0.09617443, 0.04462769, 0.1148728, 0.09594587, -0.0044476874, 0.084933236, -0.07258908, -0.07302802, 0.063680604, -0.022987427, 0.09897196, 0.0021392005, 0.030041233, -0.022118146, 0.05498059, 0.08550435, 0.002243704, -0.03217447, 0.12916483, -0.063844435, -0.027213594, 0.0029841673, -0.04619454, -0.040333558, -0.05582365, -0.048422884, -0.051895097, 0.006703286, -0.07258037, -0.067822844, 0.0053387075, -0.0003956173, 0.009916575, -0.02711427, -0.0069816513, -0.009085669, -0.027481904, 0.14788614, -0.028968705, -0.0030310685, 0.088354744, 0.031164337, -0.021571422, -0.13932268, 0.0053991172, 0.102378584, -0.030495433, -0.026907472, -0.010659767, 0.039464444, -0.06359181, 0.021650214, 0.10157952, -0.12710834, 0.035720777, 0.020898353, -0.034758724, -0.07310908, 0.04449476, 0.02814548, -0.111219205, -0.009512408, -0.056728404, -0.06315933, 0.043771792, -1.5337267e-33, 0.021354454, -0.040554464, 0.07164873, 0.018573303, 0.05044832, 0.038805198, -0.03526879, 0.004736013, -0.009697572, -0.077678464, -0.01467733, 0.09817584, -0.06144001, 0.005984206, -0.06586516, 0.030849881, -0.0236578, 0.06544887, 0.009919172, -0.024452105, 0.04687143, 0.058654167, 0.020931458, 0.03682086, 0.0061134836, -0.03306177, 0.040382463, -0.08655831, 0.073702775, 0.046287257, -0.06955208, 0.042650584, 0.017628971, -0.03403773, -0.002908133, 0.009132757, -0.11419414, -0.07449819, 0.051460616, 0.015374475, 0.01213659, 0.035597786, -0.051498093, 0.10084462, -0.00927345, 0.0074715777, -0.006295535, -0.050697453, 0.00090537703, 0.040976968, 0.033611957, -0.028414605, -0.04388659, -0.028430192, 0.05135961, 0.047410976, 0.0015234668, -0.059353594, 0.0060139773, -0.005707304, 0.037020177, 0.13242757, -0.09764184, 0.041524313, 0.010939085, 0.020496018, -0.06890582, -0.010319471, -0.005667594, -0.021532323, 0.021649951, 0.024927912, 0.0022921371, -0.027706712, -0.06625502, 0.018274952, 0.056432713, -0.025069067, -0.035702772, 0.011757321, -0.0025694715, -0.0022850663, 0.059673402, 0.035124034, -0.10739606, 0.034087118, -0.007926494, -0.028397081, 0.030235266, 0.077702686, -0.113117024, 0.028794289, -0.020252226, -0.013338224, -0.09153727, 7.12869e-34, -0.079113215, -0.04521794, 0.012982285, 0.10384758, -0.019753767, 0.015175081, 0.034680735, 0.01629301, 0.11375698, 0.023884496, 0.017268494, -0.07001883, 0.03825929, 0.0656591, -0.05192499, -0.05698954, 0.003653709, -0.036693253, -0.048685018, 0.045907352, 0.043401018, 0.07281885, 0.018605044, 0.006274281, 0.06871989, -0.04295866, 0.06645863, 0.07038512, -0.07398229, 0.044527516, -0.0049253837, -0.033560544, 0.046482585, -0.05314349, 0.014395533, 0.07114748, 0.069154195, 0.0842284, -0.070150666, -0.0227912, 0.039116763, 0.02930353, -0.053180244, -0.023358854, 0.020822097, 0.028278135, -0.0847539, 0.050245777, -0.007564335, -0.06560899, -0.02718627, 0.05302138, 0.011208336, 0.019349642, -0.024975972, 0.02609502, -0.047061663, -0.009939977, -0.02052261, 0.06443897, -0.035356328, -0.012237352, -0.043257996, -0.06394017, 0.060105506, 0.012665107, 0.032075025, 0.005309984, -0.020169951, -0.014452391, -0.010472111, -0.029872715, -0.012567275, -0.03044208, -0.0031011852, 0.022037303, -0.13922615, -0.014261331, -0.0813831, 0.04943615, -0.02463741, 0.006234794, 0.020069389, -0.024657223, 0.0497216, 0.108544074, 0.095155396, -0.062002968, -0.055208795, -0.037485357, 0.029355312, -0.069889806, -0.022899384, -0.010558265, -0.0038875616, -1.2150088e-08, -0.124218345, 0.019010853, 0.013634546, 0.015655434, 0.00039969973, 0.036329035, 0.025202496, -0.070136726, 0.080812, 0.078923136, -0.04809105, -0.023672858, -0.01676995, 0.009304439, -0.066488825, -0.005127458, -0.023872541, -0.073788956, 0.00591702, 0.056276225, 0.04816997, 0.023344936, 0.09117716, 8.7080145e-05, 0.06326827, -0.040767755, 0.043773253, 0.00034921683, 0.025484402, 0.010651761, -0.05194746, 0.043196246, -0.056773845, -0.018675769, -0.030668722, -0.07867349, -0.012930237, 0.105072014, -0.018213866, 0.019321607, -0.005061006, 0.07656255, 0.053268284, 0.015115152, -0.00054580567, 0.025868809, 0.022425909, 0.10575974, -0.021986727, -0.048825692, 0.039480973, 0.0227891, 0.023285212, 0.035942927, 0.027931701, -0.08255374, 0.09599518, -0.009681573, -0.07530552, 0.02481024, 0.07307427, -0.030282075, -0.02204826, 0.04465776]"
27-Oct-14,faster,atm high street,,100.0,18284,"[0.028307842, -0.03184353, -0.035335705, -0.025522413, -0.0821553, -0.02459013, 0.10789247, -0.048938435, 0.031403188, -0.06276228, 0.023094257, 0.025957115, -0.035190478, -0.032975584, 0.08680152, -0.00048297158, 0.087998435, -0.031851135, 0.007347905, 0.00763287, -0.025842363, -0.02085734, -0.020247303, -0.012588241, 0.009832443, -0.0059082336, 0.019356962, 0.075561635, -0.033321027, -0.069096886, -0.0015767926, 0.04809727, 0.07600736, -0.04894284, 0.012645955, 0.030938717, -0.0057688355, -0.009344142, 0.048237566, 0.008347172, -0.063828625, -0.06443586, -0.03124739, -0.006213641, 0.014642449, -0.013214175, 0.059996154, 0.047051005, 0.11838566, -0.01728338, 0.0255872, -0.0155309625, 0.022038966, 0.0001614656, 0.038562752, 0.056563847, 0.010088171, 0.022626117, 0.050238054, -0.056931265, -0.007908257, 0.01912395, -0.054999556, 0.0010194294, 0.0801705, -0.0021444329, -0.011285915, 0.02016433, 0.02345352, -0.03994626, -0.012796946, -0.044212908, -0.0042405617, -0.07541359, 0.014518406, 0.057560474, 0.002347943, -0.011290101, -0.010428393, 0.04122011, 0.013434687, -0.11661891, -0.0240677, -0.01461889, -0.02829561, 0.024409799, -0.09281276, 0.012009806, -0.015029781, -0.08374262, -0.003043279, 0.001267934, -0.019554185, 0.018416086, 0.052054033, -0.02484777, -0.016737709, -0.04546764, -0.07231557, 0.11646221, 0.024144033, 0.06995983, -0.07734036, 0.0076610297, 0.05373903, -0.016799698, 0.029495653, 0.030085023, 0.008701259, 0.016892163, -0.04708391, 0.0029738708, 0.09700438, -0.035245795, -0.03908399, 0.039542224, -0.021079969, -0.043805342, -0.048157863, 0.026444996, -0.0041236277, 0.025679864, -0.03638071, -0.018954568, -0.024952143, -0.05154263, 0.017022612, -2.3256577e-33, -0.022516109, 0.047158398, 0.040391777, 0.0011170319, 0.05848649, 0.00077131216, -0.03629869, -0.07182007, -0.036035903, 0.11692246, -0.008244736, -0.025304778, -0.014868397, 0.042129748, 0.0043421458, 0.0036715388, 0.04650831, 0.03278354, -0.04540208, -0.012249322, -0.083380416, -0.010759922, -0.07289439, -0.010030083, 0.04311035, 0.013060336, -0.004197443, -0.04629103, 0.16791178, 0.031758092, -0.017109279, 0.015634377, -0.0062573976, 0.048281103, -0.068037555, 0.050799303, -0.08103945, -0.039631553, -0.022123102, 0.003880185, -0.008125861, 0.015380964, -0.053619355, 0.020027066, 0.011040243, 0.09066956, -0.026725352, -0.011889, 0.016214458, 0.015815912, -0.033939626, -0.015594426, -0.24789664, 0.025813708, -0.07278267, -0.03594908, -0.0016059419, 0.023227867, -0.015634362, -0.0008407174, 0.003152087, 0.06928652, -0.06343818, 0.0800568, -0.07083603, -0.04476779, 0.0030152465, -0.025426008, 0.037174672, 0.111881875, 0.032223303, -0.041685008, 0.13425665, 0.054798864, 0.007330258, 0.012776764, -0.092209876, 0.04012725, 0.0706793, 0.0008549651, -0.040240053, 0.042796902, 0.026927328, 0.018310752, 0.13887314, -0.0014539962, -0.04226165, -0.107374206, 0.0048918324, -0.06377356, -0.15878047, 0.038443495, 0.02040049, -0.04291815, -0.033710964, 1.6051967e-33, -0.0032712903, -0.052058324, 0.019038083, 0.027240492, -0.053249117, 0.058986098, 0.035549212, 0.032355256, 0.0489429, 0.09781834, -0.067243114, 0.01243253, 0.115971915, 0.011947675, 0.09797171, -0.06581467, 0.034010213, 0.029914435, 0.024231449, 0.011962278, 0.0013717882, -0.04344405, 0.052295677, 0.025514646, -0.018195665, -0.020090764, -0.0043103714, 0.02407154, 0.00868954, -0.004788241, -0.07712749, -0.021648888, 0.010373287, 0.10148995, -0.035858817, 0.036585, 0.04493042, 0.00024990088, -0.057825092, -0.026126625, -0.03791466, -0.040443435, -0.0058337958, 0.058545545, 0.026997874, -0.0308747, -0.049805883, -0.024032269, 0.0480049, -0.047917936, -0.0020601086, -0.020245703, 0.07379972, 0.13913259, -0.01726577, 0.030294906, 0.04127222, 0.0018665484, 0.0046613, 0.031064764, 0.05217569, 0.021428237, -0.0073722117, 0.069587596, 0.033204112, 0.014604876, -0.036261275, -0.006082386, -0.07289344, -0.008567933, -0.0041466216, -0.0066277273, 0.021453407, 0.08827065, -0.07656295, 0.043752994, -0.01467291, 0.05038539, 0.031795226, -0.028993806, -0.019461406, 0.06265257, -0.084855966, 0.15919988, 0.0033938452, -0.01621215, 0.052444763, -0.044796113, -0.0047136853, -0.05279485, -0.035000294, 0.034210384, -0.049462035, -0.10218382, -0.0572429, -1.1754848e-08, -0.079578355, 0.053510014, 0.025065435, -0.027391123, 0.06361918, 0.033266522, 0.012850083, 0.057379007, 0.009092918, 0.05300705, -0.019111242, 0.016642174, -0.0368859, -0.019342603, -0.03561027, -0.071163185, -0.035047892, -0.062441994, 0.009137642, 0.025640516, 0.0416286, 0.08107943, 0.09639011, -0.02350767, -0.015730832, -0.016099425, 0.044724166, 0.10505492, 0.013195522, -0.0012670971, -0.018447343, 0.014292335, 0.0075142896, -0.036805116, -0.02306263, -0.022267131, 0.021141915, 0.056085985, -0.00785294, 0.014911267, -0.033521276, -0.15932067, -0.009133402, -0.081162065, 0.013725063, -0.02539921, -0.05374825, -0.024178157, 0.0096454555, -0.054630317, -0.0313391, 0.0152511615, 0.08571638, 0.04267983, 0.04566567, -0.017888771, -0.065635234, 0.012369813, -0.022020465, 0.050061706, 0.17202404, 0.04308472, -0.121188805, 0.018322283]"
01-Nov-14,bacs,acron advertising studies,,150.0,18184,"[-0.08556318, -0.031975612, -0.09601845, 0.021193957, 0.05959179, -0.0059592724, 0.013517658, 0.040577047, -0.029512566, -0.09322249, 0.0386824, 0.014114849, 0.022798946, 0.01881765, 0.011501615, -0.038955074, 0.025823645, -0.039004374, 0.045060564, -0.094520874, -0.043461423, -0.028254347, 0.032536734, 0.010209247, 0.02148192, -0.124037825, 0.004885619, 0.026021598, -0.025538065, -0.008585607, -0.059373945, 0.03684989, 0.059495527, 0.01969063, 0.02611113, 0.061574716, -0.04584271, -0.02658558, 0.031187423, 0.016196996, 0.0023553919, -0.011148325, -0.016715188, -0.052413948, 0.0338953, -0.13367824, -0.005817794, 0.06260235, -0.047815043, 0.13303371, -0.012448996, 0.0365919, -0.019814603, -0.032544944, -0.058352176, -0.04887529, -0.019950507, 0.011062135, -0.04153326, 0.02928072, 0.006836075, -0.05630884, -0.12678026, 0.06069541, 0.009913583, 0.016447043, -0.092536904, 0.07701634, -0.075009264, 0.0017343403, 0.084755674, -0.05531591, -0.047727715, 0.046261333, 0.09144543, -0.009414283, -0.0036533677, -0.04731633, 0.026898867, -0.024554932, 0.07589934, -0.08165292, -0.069230065, -0.0054366295, -0.0054685147, -0.015258, -0.019800512, -0.046674952, 0.0034334373, 0.0051050745, 0.012998719, -0.0031113632, -0.05505737, -0.0021604623, -0.018465638, -0.016083067, -0.009438795, 0.01103185, 0.0031361298, 0.13687043, -0.007354604, 0.059141286, -0.016341843, -0.093835644, -0.11196428, -0.092817836, 0.0058615473, 0.066979446, 0.032927025, 0.063470356, -0.100184135, 0.051187195, -0.050155368, -0.07240884, 0.050964553, -0.04420425, -0.06374365, -0.017927641, 0.08410114, -0.021194588, -0.004885664, 0.039623786, -0.029301368, -0.011569742, 0.0991823, -0.03340205, -0.07114958, -4.8982955e-34, -0.068929754, 0.05334133, 0.028153438, 0.059394125, 0.01517352, 0.047831558, -0.072002955, -0.04701598, 0.0051690345, 0.05817098, 0.018941019, 0.10962558, -0.03219193, 0.022672608, 0.031377994, -0.0034169974, 0.00026137434, 0.022122655, 0.023053417, -0.009372038, -0.010479663, 0.07848835, -0.0017966904, -0.03488645, -0.009256072, -0.09026105, -0.028142733, -0.0037577967, -0.015752526, 0.04050769, -0.0035602332, 0.084810816, -0.039338563, -0.020477593, -0.056226023, 0.019772476, -0.09618288, -0.11453314, 0.05263967, 0.020514317, -0.027593914, 0.095970176, -0.0008434257, 0.0050463397, -0.024293888, 0.100303456, 0.04116353, 0.033240423, 0.034940273, 0.09907109, -0.04076298, 0.03172032, -0.05387794, -0.008495019, -0.022364845, 0.02428377, -0.02897138, -0.071689785, 0.0042314236, -0.07980564, 0.06647886, 0.063340135, 0.032775924, -0.046880677, -0.111075036, 0.09797736, 0.010196985, -0.049695123, 0.06043893, 0.017634878, 0.053753883, -0.04618452, -0.07163614, -0.028539265, 0.007973249, 0.020667545, -0.03325929, 0.0407062, 0.001052213, -0.017035313, 0.02364829, -0.1355534, 0.08942947, 0.018810082, 0.02935907, 0.036286503, 0.02409296, -0.029969448, 0.06800506, 0.003246954, 0.052376732, 0.06398669, -0.05469145, 0.06151969, -0.062987275, -1.3524434e-33, -0.124860115, 0.00640543, 0.04408376, -0.040705048, -0.045650322, -0.007143116, -0.04106706, 0.016667373, 0.08359374, 0.10628271, 0.0028404733, -0.013784888, -0.034750495, 0.013695887, -0.017970543, 0.020210773, 0.13216059, 0.01198135, 0.04144897, -0.010174248, 0.0014682373, 0.045231976, -0.029585045, 0.022984711, -0.05946643, 0.019081514, -0.005331651, -0.009557708, 0.047040682, -0.016704718, -0.033796277, -0.07473917, 0.03399675, 0.039959706, 0.030182628, -0.022032976, 0.11968514, -0.029372, -0.071494214, -0.035998434, 0.06618443, 0.013631041, -0.0042980206, 0.012727367, 0.046787024, -0.08025521, -0.01715214, 0.004853198, 0.029258369, -0.010180011, -0.009014564, 0.02427968, 0.052745655, -0.03155663, -0.08886886, 0.03479849, -0.0010270478, -0.02943321, 0.026056334, 0.003561801, -0.007545697, 0.012224645, -0.068269216, -0.026418041, 0.025778553, -0.10020814, 0.058547743, -0.017543657, -0.023905128, -0.02935449, 0.059747215, 0.071613826, -0.065947756, -0.06464101, -0.15464093, 0.01063929, 0.064752, -0.003813236, -0.030426806, -0.028739676, -0.07287255, 0.038682193, 0.008526749, 0.03147166, -0.028355747, 0.055461854, 0.025539555, -0.054137684, -0.07617941, 0.03445143, 0.034213662, 0.013172724, 0.016880397, 0.052666716, -0.0074945134, -1.47336365e-08, -0.067320004, 0.0033122005, 0.07770253, 0.030660322, 0.026058141, -0.018769626, 0.042015415, -0.01901484, 0.0028288614, -0.013805896, -0.037762605, 0.096259914, -0.0031799688, 0.07052766, -0.0031026765, -0.0072355196, 0.028927019, 0.04132969, 0.005536131, 0.023183221, 0.011600085, 0.06898688, 0.09875355, -0.024373526, -0.025968987, 0.05764783, 0.039894067, 0.020103509, 0.021480724, -0.0036705085, -0.13759683, 0.034326993, -0.019679619, -0.059459366, 0.048228327, -0.063429, 0.023295883, -0.036518455, -0.0102739, -0.010049043, -0.027344786, -0.038132805, 0.05923109, 0.06022968, 0.12014268, 0.0047175623, 0.018221697, -0.04106988, 0.05703596, -0.013961164, 0.018839076, 0.017543305, 0.02164934, -0.033957824, 0.05767369, -0.123594925, -0.039372083, 0.004449079, -0.008603092, 0.043171752, 0.08344336, -0.013851236, -0.03257281, 0.033266887]"
01-Nov-14,bacs,marriott hotel,,177.0,18034,"[-0.012964869, 0.040571164, -0.031411678, 0.07173537, -0.02096474, 0.030696973, -0.025975525, -0.040737674, 0.06552766, -0.060949456, 0.0531741, 0.027577544, 0.036728077, 0.051950634, 0.07806366, -0.052352462, 0.0239223, -0.003366831, 0.07040306, -0.0040365593, -0.049933907, -0.04152691, -0.07045009, -0.014193782, 0.022643484, 0.019801956, -0.044595562, 0.039298743, -0.05352922, -0.032788448, 0.0049574026, 0.06326938, 0.017652305, -0.0039413227, 0.054691933, 0.13361406, -0.003875818, -0.04960691, 0.058602635, -0.02512299, -0.00452102, 0.0007169228, 0.0739149, -0.017941747, 0.033448093, 0.030526135, -0.046981126, 0.03732173, 0.03532756, 0.06650166, 0.0031561977, 0.02901782, -0.011023674, -0.017792217, -0.0043122773, 0.03815453, -0.027019504, -0.05635361, 0.044661682, -0.0010885634, 0.03980977, -0.0208545, -0.022946248, 0.056839954, -0.0819326, 0.0068714363, -0.012834091, 0.08276162, 0.008018919, -0.15335672, 0.020407876, -0.009537795, -0.0058643706, -0.008905397, 0.0063064652, 0.0021117607, 0.019206237, -0.019069048, 0.0159527, 0.025870066, -0.0069732587, -0.09997204, -0.031420518, 0.052856736, 0.0039545754, -0.011763468, 0.012199267, 0.02360607, -0.0068076258, 0.026521906, -0.025583792, 0.018536137, -0.13983919, 0.017833166, -0.05350297, 0.058922715, -0.07741445, 0.03890984, -0.10578406, 0.13881402, 0.0842551, 0.08385415, 0.062977895, 0.008062626, 0.01495709, -0.043235045, 0.10564199, 0.10878299, 0.019513214, -0.056298118, -0.043867137, 0.03858719, 0.02637974, -0.07015176, -0.024348726, 0.019323705, 0.08958429, -0.033935394, 0.03005962, 0.001136162, 0.06471414, 0.010462701, -0.0016672347, -0.021370407, -0.13626151, 0.012961394, 0.0070319204, -1.8869428e-33, -0.036815196, -0.038496137, -0.0029223973, 0.042424347, 0.04892695, 0.090174556, -0.046323888, -0.024637027, -0.06181231, -0.030661134, 0.007842538, -0.067196, -0.027859632, -0.03349987, 0.018674793, -0.016426219, 0.08872943, 0.036213305, -0.01322092, -0.10512982, -0.016581595, 0.03129166, 0.07447196, 0.018529834, -0.040695194, 0.019340878, 0.091415934, -0.019148486, 0.015419636, 0.032934997, 0.03679429, -0.074811496, -0.05332278, -0.022519242, 0.039977893, 0.03331547, -0.044400644, -0.045062248, -0.07381183, -0.027525133, -0.10553144, 0.01561508, -0.08598508, 0.07935365, -0.048697107, 0.06308536, 0.006267883, -0.0029446066, 0.064294755, 0.072083406, -0.017823134, 0.0095055215, -0.1578186, 0.020856293, -0.019425206, 0.010505901, 0.01192907, 0.0044140317, 0.027714482, -0.081832364, 0.005862344, 0.044025656, -0.10248628, 0.009801091, 0.04808683, -0.014434666, -0.018558297, -0.03738336, 0.01250301, 0.01177375, 0.061622113, -0.047199473, 0.021472152, 0.04957916, 0.0071502724, 0.03132642, 0.0055059795, 0.06665453, 0.05738801, -0.0044702548, -0.0066884956, 0.055055395, 0.048591673, 0.08877503, -0.05456594, -0.024959901, 0.02750505, -0.011693522, -0.02667913, -0.041370973, -0.045544885, 0.029281951, 0.10231887, -0.0439661, 0.007418849, 1.082131e-33, -0.030054439, -0.081625946, 0.021588843, -0.061821245, 0.0071867094, 0.04606454, -0.024847005, -0.008048005, -0.04045744, 0.045350067, -0.044714734, -0.030033136, 0.026724158, -0.0323724, 0.02294594, 0.080850914, 0.09245776, -0.019979693, -0.06785835, 0.066958904, 0.049209878, 0.06398353, -0.008519967, 0.0930761, 0.010361699, 0.072205104, 0.0027031624, -0.0068603256, -0.060417116, -0.05169891, -0.0034915635, 0.0072334968, 0.0068174643, 0.11870972, 0.009748393, 0.070672296, 0.02377147, 0.08002648, -0.058669616, 0.035212673, 0.07377257, -0.08915149, -0.08099366, 0.049620125, 0.04033076, -0.030865937, -0.020927068, -0.06974932, 0.050181903, 0.045835435, -0.13562603, -0.07121427, -0.061577808, -0.060986504, -0.0056087766, -0.034864772, -0.09244601, 0.016343957, 0.067323916, -0.024432186, 0.021519512, -0.008164639, -0.018466257, 0.074961066, -0.04582927, 0.010530022, 0.022523532, -0.028328927, -0.058063876, 0.019865949, -0.00017610141, 0.06084752, -0.06449116, 0.015276254, -0.023622211, -0.024260854, 0.033579282, -0.032348316, -0.08856668, -0.05742643, 0.07082737, -0.04258778, -0.057740446, 0.017406166, -0.046469584, -0.11050573, 0.11718827, 0.01767782, -0.0009787265, -0.036256056, -0.03422113, 0.046484414, -0.10041615, -0.067190886, 0.018221822, -1.2430968e-08, -0.045345347, 0.021061044, -0.019792704, -0.039680295, -0.073320985, -0.11491183, -0.01217725, 0.038656846, 0.045791823, 0.015437, 0.0032647997, -0.00040229957, 0.038768884, -0.07226555, -0.09716084, 0.0038111473, -0.05044457, -0.009927221, 0.03140873, 0.055009723, 0.0629225, 0.02177635, 0.031023966, 0.021012079, -0.03063468, 0.005498703, -0.028238002, 0.03613509, 0.10396719, -0.0837155, 0.07348363, 0.046536483, 0.016566252, -0.083456695, -0.1094052, 0.014718364, 0.024700163, -0.073967874, -0.024629518, 0.020440703, -0.046512827, -0.014426147, -0.021527132, -0.017774183, -0.050913144, 0.033385016, 0.0615962, -0.01169658, 0.00835249, 0.08011735, -0.08682776, 0.012802351, -0.005985633, -0.021106144, -0.031935055, 0.029180335, 0.05199558, 0.007224057, 0.009507001, 0.0050208895, 0.061630398, -0.030709062, -0.0076353615, 0.03293156]"
01-Nov-14,faster,abellio scotrail ltd.,,122.0,17857,"[-0.029436659, 0.04568981, -0.03286889, 0.039093904, 0.019019952, 0.0011590546, -0.00300936, 0.026957465, -0.014831389, -0.029439513, -0.016175827, -0.0070821317, -0.0595285, -0.008091677, -0.066908665, 0.063864775, -0.023027675, -0.009494532, 0.026370192, -0.03573798, -0.012421041, -0.0010716448, -0.00845111, 0.12768804, 0.01696425, 0.03437212, -0.06940488, 0.021756895, -0.016612912, -0.080713905, -0.009816229, -0.0070716334, -0.036222294, 0.026243815, 0.042186406, 0.015565628, -0.007322216, -0.028381577, 0.033079185, -0.06591433, 0.046671465, -0.004956281, -0.02364418, -0.031119816, 0.007025198, 0.034934442, 0.035226777, 0.04915517, 0.0068853237, -0.0073066517, 0.0021801402, -0.09242666, -0.004647426, -0.032235455, 0.0019523617, -0.018352464, -0.049387544, -0.019762307, 0.09167452, -0.021850318, 0.062915735, -0.030905472, 0.02936255, 0.004282441, 0.07796094, -0.03246079, -0.06990885, -0.02831174, -0.0054671923, -0.03358381, 0.15615603, -0.08282662, 0.035709165, 0.010310043, -0.12509358, 0.022433784, 0.031337623, 0.1150521, -0.05357226, -0.0054058735, -0.011758841, -0.064248316, -0.054828543, 0.032960963, 0.05952589, 0.023320533, 0.044329535, 0.05340694, 0.031838506, -0.024133105, 0.018094204, -0.021488067, 0.039691452, 0.049102858, -0.089279115, -0.036880124, 0.00904348, -0.060510714, -0.06928812, 0.110042006, 0.0439341, 0.03887869, -0.018414272, 0.004342437, -0.036104135, 0.01774481, -0.04297699, 0.041230783, 0.03532501, 0.034756746, -0.031893246, 0.0012944874, -0.06641176, -0.0047552963, -0.05494608, -0.04919879, -0.13818842, 0.009237073, 0.03856251, -0.027698973, 0.053171184, 0.04662513, -0.03141351, -0.0036899347, -0.055267524, -0.03376723, -0.0492332, 1.1293625e-34, -0.076328665, 0.040513583, -0.0020503502, 0.04062906, -0.037763044, -0.057909504, -0.053675465, 0.045836784, -0.10885703, 0.0089094, -0.0515375, -0.0016214466, 0.029993027, 0.01589615, 0.041994363, -0.11294582, -0.08901465, -0.062744856, 0.084807165, -0.054786883, -0.064930074, 0.018829716, -0.067034, 0.062685154, 0.031834286, -0.08002083, 0.025315136, -0.035518568, 0.0072595472, 0.09909682, 0.09532807, 0.07415775, -0.045056686, -0.016682126, 0.0012588929, 0.0150219835, -0.035553705, -0.094715096, -0.06313885, 0.05358036, 0.0008587779, -0.0027899444, -0.03576373, 0.034390237, -0.01546588, 0.05159116, 0.03623709, 0.026515823, 0.08616727, -0.03250097, -0.102140434, 0.0062271366, 0.009681797, -0.028435117, 0.06525706, -0.05513727, -0.050679646, 0.03184411, 0.04695619, -0.062469795, -0.005255716, 0.069723666, -0.123341076, 0.06251584, -0.11258457, 0.011664451, 0.02054094, -0.019957019, 0.022496324, -0.04768174, -0.007889586, 0.051856898, 0.1339818, 0.062739745, -0.07730645, -0.0492861, -0.053964686, 0.073555216, -0.044025928, 0.09493978, -0.020785287, -0.060038038, 0.046575185, -0.0024114645, 0.08976567, 0.021792125, 0.03441244, -0.05090158, -0.0327949, 0.02874271, -0.0903036, 0.02207239, 0.03394708, 0.07260115, 0.014581781, -8.728727e-34, 0.011043918, -0.04862893, 0.1083454, 0.020202959, -0.052060142, 0.002426917, 0.035081185, -0.038943984, -0.02511379, 0.082345836, -0.02479132, 0.030848077, 0.10003201, -0.009632239, 0.040316384, 0.00019234608, 0.04559219, -0.0751203, 0.022292022, -0.051138826, 0.0019973235, 0.0300163, -0.09095672, -0.050858, 0.006541714, 0.05945521, 0.013521135, -0.037782535, -0.0084635, -0.047012288, -0.02394009, 0.0058014584, -0.111352205, 0.08061257, -0.054217707, 0.008916041, -0.0074387332, 0.043427426, 0.022043787, -0.056454018, 0.055953432, 0.08466723, 0.07069202, 0.080924384, 0.043369964, -0.027999701, 0.0416869, 0.04882947, 0.09941823, -0.003308033, -0.0077972123, 0.08723055, 0.011714986, -0.09256833, 0.07814002, -0.011286304, -0.052899927, -0.024866708, -0.07529659, -0.021418985, 0.1402669, 0.044987444, 0.038481608, 0.050651666, 0.0025000018, 0.018911881, -0.08526492, 0.009080761, 0.04047172, 0.00071559666, 0.03347487, -0.07412693, -0.02358191, -0.040256537, -0.008342817, 0.07513204, -0.0282495, 0.026049398, -0.060415655, -0.038744196, 0.12500112, -0.06802846, 0.022336992, 0.067926906, 0.05854746, 0.031125715, -0.008483447, -0.042466216, 0.07105477, 0.03062705, -0.05673346, -0.05583327, 0.032029096, -0.0064282264, -0.02069941, -1.5154175e-08, 0.03427045, -0.0077473605, -0.018586662, -0.03336767, 0.068898804, -0.061192546, -0.00066730694, 0.014430445, 0.0053071706, 0.020173712, -0.02764517, -0.007416077, -0.08472794, 0.09394501, -0.075771816, -0.013479319, -0.05538047, 0.079690084, 0.028884241, 0.010608133, 0.0055221487, 0.004871955, 0.030585911, -0.028324524, -0.063456744, 0.01828864, 0.049638487, -0.016645676, 0.047927305, -0.023134626, -0.03386104, 0.0449215, -0.00931216, -0.03575287, -0.04633293, 0.026700225, -0.022202399, 0.060584195, 0.0303394, -0.013548517, 0.021420266, 0.028841218, 0.07432727, 0.004717871, 0.0013252763, -0.030829152, -0.0893962, 0.040251676, 0.021762604, -0.069091775, -0.010895017, -0.01358664, 0.028781448, 0.113877624, 0.025084378, -0.0043718386, 0.02475344, -0.066460185, -0.082047805, -0.062400788, 0.036216732, -0.061664313, 0.02611935, 0.02720568]"
01-Nov-14,chq,cheque,,1200.0,17735,"[-0.022080716, 0.09332693, -0.015996603, 0.02311432, -0.04235004, -0.008001289, 0.23489736, 0.031299826, 0.07511041, -0.04182964, 0.07055444, -0.068940505, 0.0101831425, -0.0426192, -0.025969215, -0.06531255, 0.08003002, 0.009023818, -0.053688604, -0.026218474, -0.09112537, -0.08100661, 0.03913183, 0.016712217, -0.037534993, 0.005422387, -0.013211829, 0.019466314, -0.024309041, -0.08399769, 0.010753006, 0.095355965, 0.007664148, -0.030919215, -0.013560081, -0.04883897, -0.03255911, -0.007715576, -0.04025462, 0.007879756, -0.0238404, -0.07987913, 0.00663048, -0.013200811, 0.0015922458, -0.0135728065, 0.055810392, 0.059447177, -0.0193201, 0.052708693, 0.006700152, 0.023217905, -0.09004698, 0.010769376, 0.029597927, -0.029036084, 0.006555786, 0.042731334, -0.025207872, -0.059391428, -0.0054215975, 0.0014671746, -0.06412389, 0.04194374, 0.08610819, -0.0077828774, -0.002914642, -0.043024573, 0.036761474, -0.04758068, 0.051411808, -0.031856615, 0.050393686, 0.026267452, 0.011286956, -0.009392196, 0.06103011, -0.08250417, 0.030918531, -0.01441988, -0.032872416, -0.017684288, -0.088905066, -0.008515527, 0.02714835, -0.032891203, 0.022338986, -0.016045049, 0.0525687, -0.07222644, 0.023977604, 0.042743366, 0.052547563, -0.09683445, -0.066975065, -0.0061033024, -0.018894436, -0.005857738, 0.09599739, 0.16050684, 0.07557703, 0.054282974, -0.1224162, -0.040694244, -0.018743541, 0.07145177, -0.027843852, 0.04208655, 0.035281353, 0.035876565, -0.07565742, -0.007894618, 0.1035866, 0.00924273, 0.031868596, 0.09949478, 0.021210743, -0.017595926, 0.030275043, -0.08093372, 0.031431578, 0.03579772, -0.13738725, -0.066097565, -0.06199596, -0.086215824, 0.05926673, -3.748267e-33, -0.03676772, 0.007377536, 0.08182168, 0.0041383835, 0.018665463, 0.0073957383, 0.008492173, -0.0023128341, -0.07776029, 0.1353966, 0.004219839, 0.011827175, -0.028963884, -0.026067728, -0.030598417, 0.07282304, -0.0717716, 0.014782604, 0.04260179, -0.0015716793, -0.045237888, -0.021519814, 0.025383314, 0.07806491, 0.058927014, 0.074032485, -0.03650983, 0.03472863, 0.01027006, 0.01615826, 0.030071996, -0.0033428639, -0.042989656, 0.008839058, -0.044521216, 0.019510597, 0.0114701465, 0.010169446, 0.05463155, -0.07065607, -0.0005932928, 0.010779678, 0.054660115, -0.00035732964, -0.050483305, 0.018551068, 0.018073484, 0.045702983, 0.05568757, 0.018968377, -0.006763023, -0.0129617555, -0.03749675, 0.012676703, -0.041616794, 0.01572258, 0.08777902, 0.025815327, 0.008402005, 0.027707018, 0.046665017, 0.066923074, -0.08032929, 0.005330795, -0.027939176, 0.016821845, -0.041441243, -0.011156893, 0.102763906, -0.020397851, -0.057569727, 0.027167866, 0.120856464, 0.0048387498, 0.022467237, 0.024079084, -0.02135662, -0.00021123167, 0.045861553, 0.06799478, -0.010511697, -0.051165465, -0.020612339, 0.049192507, -0.017841764, 0.017075488, 0.045266952, -0.025914896, 0.010601763, -0.011300332, -0.09187598, -0.06420421, 0.068397045, 0.0053538186, 0.019262457, 1.7268398e-33, -0.054161306, -0.046475004, -0.021182153, 0.07414034, -0.014242135, -0.04331785, -0.0014735446, -0.09578834, 0.038516138, -0.00042590583, -0.020748386, -0.0721329, 0.16412099, -0.057485722, 0.01875903, -0.008727093, 0.051951353, -0.004681471, -0.008536263, 0.08046764, -0.0027075016, 0.022671603, -0.01199581, 0.055084214, 0.015259307, -0.002712602, 0.06054732, -0.1146592, 0.020297272, 0.093421504, 0.015668947, -0.0348847, 0.022104273, -0.0057809027, -0.052557744, -0.103331745, 0.07502831, 0.005124684, -0.01415224, 0.0353224, -0.022948783, -0.10164387, 0.057487953, 0.09224659, -0.0056893704, -0.079213776, -0.07680036, -0.0030447338, 0.04133635, 0.050809685, -0.0029089055, 0.031219067, -0.08286581, 0.065290935, -0.010999947, 0.1589874, -0.04971053, 0.0037875695, 0.031137511, 0.025263725, -0.0070535806, 0.04741582, -0.014401228, -0.031648565, 0.009646107, 0.052775413, -0.076215364, -0.02905403, 0.093905814, 0.0065502888, 0.04144047, -0.011471919, 0.040418915, -0.08809287, -0.05932311, -0.0040021357, -0.006911763, 0.053644307, -0.020001657, 0.07023282, -0.06869921, -0.04830572, 0.022794154, 0.049003944, -0.03173901, -0.06856208, -0.026730686, -0.06774882, 0.011497096, -0.0678026, -0.033036195, -0.056534465, 0.07138007, -0.07917027, -0.06224418, -1.32901485e-08, -0.0659499, 0.026979864, -0.023196865, 0.033184126, 0.051869545, -0.05812255, -0.01991713, -0.012606907, -0.06827607, -0.002469762, 0.0772922, 0.0077216565, -0.03159934, -0.035341688, 0.03630994, 0.0019584342, -0.0020232012, -0.0039810757, -0.031984724, -0.023706192, -0.021208955, 0.03175466, -0.07936709, -0.0106901275, -0.06579927, 0.026648117, 0.039125692, 0.033242848, 0.032059167, -0.00086151744, -0.031545114, -0.0030043963, 0.0003771029, -0.053975925, 0.110206336, -0.04896067, 0.023625022, 0.0028793963, -0.020114075, 0.00090613274, 0.0028564027, 0.016810184, -0.106807865, 0.02766322, -0.016390057, -0.0049186256, -0.026574148, 0.012466588, -0.030921634, -0.027113771, 0.037078604, -0.051835448, 0.0019788342, -0.039557155, -0.016034443, 0.038625203, 0.032627728, 0.0053598434, -0.07301808, 0.024654975, 0.06576088, -0.062259413, 0.0832125, -0.086293265]"
01-Nov-14,int,interest paid,9.33,,16535,"[0.0066877482, 0.06256221, -0.038943335, 0.019258568, -0.02388958, -0.057548337, 0.12100913, 0.022768388, 0.06272762, 0.0694891, -0.013397983, -0.034353554, -0.035490982, 0.008639179, -0.017665796, 0.010746014, -0.056716215, -0.0045864373, -0.022702023, 0.029388934, -0.005274043, -0.041741464, 0.0070632203, -0.0333085, 0.114213504, 0.06935974, 0.04713463, 0.0010082014, 0.03396795, -0.042324033, -0.009801521, 0.082406394, 0.09799834, -0.057847094, 0.012986007, 0.026482668, -0.03366372, 0.037337482, -0.054230135, 0.040403508, -0.021412881, -0.044248573, 0.06248451, -0.040523898, 0.02132173, 0.008006706, 0.02106651, 0.057561833, -0.029856082, 0.13989379, -0.04137531, -0.08174323, -0.05469427, 0.04459929, 0.000972864, 0.021773705, -0.011312995, 0.03895199, 0.026820984, -0.07621161, 0.022461316, -0.01958259, -0.049762923, -0.022964325, -0.01136172, 0.00046627584, -0.017568456, -0.0032170485, -0.058601752, -0.058898322, 0.03581065, -0.003146759, -0.02412595, -0.13277055, 0.012599992, 0.016111251, 0.09595976, -0.005937249, 0.043798774, -0.0803103, -0.010792483, -0.07654262, -0.035110272, -0.0875724, 0.009478085, -0.034113422, 0.05650966, 0.022094695, 0.061333425, 0.00046378167, 0.018357677, 0.02739571, 0.011483238, -0.11980905, -0.10045082, 0.033808175, -0.0060031465, -0.0022216986, -0.08018021, 0.15272446, 0.064756975, 0.079796284, -0.05724914, 0.04695, 0.0012760857, 0.02829616, 0.061361082, 0.07189332, 0.058710255, 0.0050572064, -0.06975254, 0.032439888, 0.048931047, -0.0028560509, -0.0006366987, 0.032248344, -0.07368094, 0.0056250175, 0.08498348, 0.0023492612, 0.09164018, 0.073049225, -0.08739459, 0.0281552, -0.08796737, -0.114717, -0.029568883, -3.0645228e-33, 0.016197056, -0.03223274, 0.02375595, -0.08317573, -0.014123847, -0.011972079, 0.021226238, 0.07759266, -0.067352764, 0.049763914, -0.013612415, -0.00766376, -0.017312907, -0.015232605, 0.021115785, 0.007384408, -0.077032745, 0.03679036, 0.078256726, 0.04618249, -0.065146394, 0.043409765, 0.037286688, 0.058503363, 0.0013990663, -0.039722428, 0.009051063, -0.051328514, 0.022318246, 0.011267251, 0.03231339, 0.057363406, 0.019708568, -0.047968533, -0.03306471, -0.0030859313, 0.063381635, 0.015171582, 0.06590124, -0.013801575, 0.026217677, 0.021684762, 0.016202904, -0.024662338, -0.08796973, -0.0071808994, 0.021066787, -0.011389632, -0.026548082, 0.11319672, -0.016632836, -0.07259702, -0.10482037, -0.011951158, -0.053661913, 0.0074040266, 0.011658354, 0.05050271, -0.07694813, -0.037470043, 0.06789335, -0.033722088, 0.0025292195, -0.005087224, -0.17897767, 0.05087067, 0.03236043, 0.008722586, -0.017068345, 0.032079965, -0.12021255, -0.035853308, 0.10891366, 0.03493337, -0.03343133, -0.04283126, 0.00581312, 0.015898192, 0.028476294, 0.089751035, -0.008454764, -0.026456542, 0.0291019, 0.031870835, -0.012093731, 0.07392758, 0.04448531, -0.09264033, 0.08028943, -0.05615784, -0.07151031, -0.040791024, 0.040635135, -0.005579322, 0.1001947, 1.743524e-33, -0.054344065, -0.008053795, -0.06494615, 0.04655152, -0.056302916, 0.024561185, -0.020592166, -0.053940892, 0.03838817, 0.06968122, -0.044787392, 0.027217988, 0.042786855, 0.0789036, 0.053929333, -0.08614977, 0.04261345, -0.021979269, 0.019859107, 0.0697688, -0.05824131, 0.057027165, 0.08385594, 0.0030117342, 0.008518348, 0.067305155, -0.0046074037, -0.025297223, -0.042995997, 0.045287535, 0.0038024078, -0.057276405, -0.03666151, -0.009089355, -0.054648157, -0.022395482, 0.006009684, -0.035895873, 0.0045400993, 0.0035926835, 0.11932297, -0.06564852, 0.025337098, 0.080927774, -0.011834269, -0.07584574, 0.032175343, 0.017707372, 0.03234836, -0.00038146845, -0.08135845, -0.055162266, 0.0011443807, 0.021749897, -0.044128608, 0.03760575, 0.074026324, 0.010837773, 0.02795635, 0.002987238, -0.029731834, 0.023703523, -0.007182352, 0.019019151, -0.0099556325, 0.012748764, 0.009380197, -0.03214069, 0.08160568, -0.0653618, 0.049529135, 0.05695775, -0.043210257, -0.017328244, -0.013943686, 0.1077594, -0.0087251505, -0.00071115914, 0.015953863, 0.0005772592, -0.084162615, 0.052350592, 0.028069055, -0.035280395, -0.047799256, -0.04306295, 0.015408113, -0.037429824, -0.10262696, -0.09432212, -0.030391678, 0.05354964, 0.09702398, 0.05797914, -0.074037276, -1.3261581e-08, -0.021661177, 0.0648897, -0.038814176, 0.032128863, 0.107857466, -0.11068996, -0.027968267, 0.027255708, -0.034009773, 0.039251618, 0.049582176, -0.030053897, -0.030623, -0.003186843, 0.019367572, -0.05160965, -0.040977098, 0.011054516, -0.07871491, 0.023868682, 0.0148879755, 0.027268842, -0.03893793, -0.029259736, -0.04703093, -0.004726006, 0.08155274, 0.0925256, 0.042099133, -0.0028993655, -0.04644017, 0.08009945, -0.007665654, -0.050180685, 0.013655322, -0.09266251, 0.03799519, -0.00076281856, 0.0153796375, -0.019602878, -0.0025833454, -0.043235596, -0.028556833, -0.035701808, 0.008010933, 0.07476494, -0.019421948, -0.071153134, 0.03270336, -0.047367267, -0.0003669807, 0.026216479, 0.04802744, -0.012050691, -0.031234698, -0.020841768, -0.0069153397, 0.043801155, -0.03751303, -0.010399465, 0.020383297, -0.10802923, -0.04774625, -0.04259604]"
01-Nov-14,dd,ovo energy,,2470.0,16544,"[-0.07760311, 0.07224542, -0.017774014, 0.115626216, -0.041393306, -0.092218444, 0.04673768, 0.03711293, 0.043694995, -0.02490177, 0.013510821, -0.024737788, -0.021632114, -0.03480168, -0.008595555, 0.025054852, 0.07411639, 0.00033906987, -0.047923177, 0.025277613, 0.094777346, -0.027577098, 0.039341863, -0.017276725, 0.09648796, 0.056730423, -0.05891271, 0.09964872, 0.053565606, -0.15628238, 0.041836422, -0.03402987, 0.027132817, -0.023645971, 0.02263225, 0.052453153, 0.040673837, 0.06692421, -0.02842377, 0.02121135, -0.07676923, -0.09797987, 0.034415733, -0.01802424, 0.020660019, -0.01593819, 0.058368478, -0.08003726, 0.028898988, -0.010497634, -0.004064636, -0.0590693, -0.03386838, 0.07457095, 0.02497285, 0.005195906, 0.049427927, -0.029364744, 0.023987668, -0.011210541, -0.032314118, -0.033479065, -0.10399056, 0.03002606, 0.07875109, -0.060289696, 0.03383191, 0.009512632, -0.069880284, -0.042683233, 0.022099534, 0.0017924245, 0.033392113, -0.03751102, 0.064846784, -0.022671955, 0.060686883, 0.019623365, 0.14163147, 0.0040949234, 0.08670495, -0.07971119, -0.12771869, -0.018371578, 0.042088754, 0.022420079, 0.0063725086, 0.003573116, 0.10941954, 0.01684752, -0.1006352, -0.030081214, 0.0075175283, -0.04528147, 0.11669034, 0.007714253, -0.024943529, -0.05758791, -0.06373884, 0.10158346, 0.015979331, 0.013481092, -0.011728045, 0.04835973, -0.014770291, 0.005550098, 0.032400705, 0.099698536, 0.10254131, 0.051424555, 0.056639027, -0.03100702, 0.009014495, -0.033949647, 0.0028255756, -0.036151644, -0.0009029497, 0.032081053, -0.028945584, -0.02451591, 0.0073804855, -0.058802254, -0.042221032, 0.04808466, -0.025507173, -0.06888134, 0.004411739, -3.444804e-34, -0.0043600155, 0.00456055, 0.017002147, -0.038702413, 0.010881133, 0.01112694, -0.021212788, -0.036943577, -0.0369422, -0.066540115, 0.0066154604, 0.035704374, -0.016596463, 0.08209135, -0.0003053886, -0.09426907, 0.019877894, 0.065232866, 0.012316323, -0.040311873, 0.02152015, 0.010170159, 0.020908212, 0.054808304, 0.049280856, 0.036686923, -0.04452509, -0.10047776, -0.07372522, 0.03576878, 0.059016865, 0.049043186, -0.016666334, 0.04446462, -0.04757521, -0.021922808, -0.06004263, -0.01927951, 0.07756522, -0.06567895, -0.011009871, 0.040378127, -0.040771697, 0.031425983, -0.04397813, -0.006401684, 0.10289392, -0.0050178715, -0.0081661735, 0.08065612, 0.01803672, 0.012815797, -0.13281524, 0.037668165, 0.063729696, 0.0051569226, -0.020343075, 0.074070685, 0.089452446, -0.04777878, 0.00491028, 0.10176471, 0.083286375, -0.021470258, -0.07464842, -0.01883869, -0.039135713, -0.044581838, 0.024742538, 0.044589195, -0.020293428, -0.023343204, -0.0043362877, -0.08154079, 0.04923777, 0.038418535, 0.023990076, -0.014553928, -0.054275975, -0.051867183, -3.648292e-05, -0.038648665, 0.050959967, -0.024375299, -0.06792049, -0.012062285, -0.029624667, -0.033343684, -0.072478116, 0.01661713, 0.039354235, -0.09789168, 0.045624018, -0.027042981, -0.07376883, 1.1873402e-33, 0.029206166, 0.014039523, -0.0075112525, 0.018746812, -0.013203201, 0.021832105, -0.06319179, -0.05792905, -0.06808553, 0.067788, -0.014094693, -0.072459325, -0.018821087, 0.016093716, 0.10053579, -0.004382143, 0.041630052, 0.0002095068, 0.022689173, 0.07764731, -0.004430429, 0.0491803, 0.009508866, 0.013709548, 0.034100894, 0.097783454, 0.008725451, -0.0706913, 0.014207366, -0.04336532, -0.058340654, 0.0141885, -0.01743473, 0.0212596, -0.016454287, 0.08896483, 0.11029089, 0.012725966, -0.024045246, -0.002866088, 0.07426928, 0.019203441, 0.027638434, 0.0011972538, -0.08943081, -0.02311905, 0.013612647, 0.007685314, -0.02648343, 0.018358678, 0.072055645, 0.01375494, -0.08458818, 0.019817527, -0.030619534, 0.015251962, 0.04249694, 0.018976482, -0.08660199, -0.1352595, 8.9606554e-05, -0.08647246, 0.045062356, 0.043468785, -0.016658908, 0.04998192, 0.027827032, -0.015738523, 0.0052548964, -0.035026267, -0.006716596, -0.014589138, 0.007823415, -0.04541306, 0.0044637998, 0.02032501, 0.05719782, -0.11085631, -0.0023743352, -0.008390044, -0.16380918, 0.0035859921, 0.024306051, -0.02183902, -0.0075818496, -0.051145386, 0.020970931, -0.024295574, 0.04147931, 0.09266046, -0.010752441, 0.012479194, 0.039852202, 0.0424106, 0.042933196, -1.25243655e-08, 0.0424742, -0.069398984, 0.07300339, 0.03679273, 0.06812364, -0.049172763, -0.018144453, -0.028057445, 0.0055879834, 0.051210582, 0.11935957, -0.013380539, 0.10371977, -0.050779793, 0.07172199, -0.031816334, 0.0081583345, 0.013769488, -0.046461646, -0.06820894, -0.025413826, 0.010028741, 0.033672065, 0.03849134, 0.0134884855, 0.03529688, -0.024979508, -0.025903337, 0.030588366, -0.016595036, -0.05230177, 0.07542698, 0.0013136502, -0.1005432, -0.04639274, -0.05746066, 0.014622082, 0.0049325465, -0.05226377, 0.06904073, 0.036163006, 0.021564595, 0.039223365, 0.02664254, -0.0501425, 0.077337086, -0.0879469, -0.084772155, -0.004259588, 0.032269906, -0.04201174, 0.07193173, -0.0029119572, 0.028960539, -0.04844528, -0.042756796, -0.07592288, -0.043090165, -0.018624175, 0.0024330446, 0.06700579, 0.005359042, -0.0033238796, -0.03350862]"
21-Dec-14,bacs,various payment,,10526.0,14074,"[-0.019175822, 0.023092942, -0.012071957, -0.036122546, -0.040704414, -0.0031406435, 0.08172043, -0.0124981925, 0.06953166, -0.0024495125, 0.0012997695, -0.04507, -0.029725386, -0.011807887, -0.04162812, -0.05647591, -0.010618882, 0.024690753, 0.023544941, 0.005334663, -0.042355303, -0.035236634, -0.049999144, -0.02724282, 0.07018306, 0.0014420468, 0.03654357, 0.015598032, 0.07430643, -0.059034184, 0.032108802, 0.064686544, 0.071064755, -0.030119011, -0.040554047, -0.053362362, -0.013504166, -0.009677722, -0.07275053, 0.04914462, 5.7984533e-05, -0.034815304, 0.017628329, -0.05663215, 0.00420117, 0.023712076, 0.002200189, 0.07794034, -0.01488832, 0.06091324, 0.023357222, -0.026509741, -0.084404536, 0.08095087, -0.034247063, -0.0958011, 0.010695954, -0.005049119, 0.036140986, -0.04649217, -0.0061071534, 0.0055143773, -0.08091619, 0.0073117837, 0.073647015, -0.00043519645, -0.008666577, -0.0044754916, -0.05325374, -0.04213603, 0.055657897, -0.052170243, 0.026059974, -0.025702864, 0.009054502, -0.017911172, 0.051433105, -0.028011316, -0.08219146, -0.058863886, -0.0016840855, 0.0052769543, -0.019377647, -0.053520214, 0.02962048, 0.0034220377, -0.043374058, 0.037584838, 0.056404263, 0.0009838097, 0.06775043, 0.060408212, 0.048823133, -0.116900176, -0.010382534, 0.031497434, 0.028573133, -0.071684904, 0.07076629, 0.123590864, 0.0783449, 0.03369018, 0.057853453, -0.014045049, 0.049488004, 0.011312573, -0.008266809, 0.030762315, 0.0036967888, -0.0003748859, -0.10142913, -0.0045826905, 0.024477907, -0.013542321, -0.05708659, 0.10612783, -0.08741855, 0.022873985, 0.08761306, 0.026360242, 0.04698771, 0.044730905, -0.04869014, -0.11563949, -0.11661152, -0.026010107, -0.04794968, -4.270927e-33, 0.02433404, -0.042075835, -0.021318447, -0.0085209515, 0.016143506, 0.04305439, 0.027570786, 0.048528135, 0.005148872, 0.026812779, -0.012531057, -0.0018238358, 0.017548226, 0.08664048, -0.013672287, 0.004830174, -0.061676707, 0.03922135, 0.09562086, 0.10467897, -0.00016461365, 0.003157721, 0.0714136, 0.0725929, 0.039401025, -0.047980122, -0.010691275, 0.01226066, 0.03341643, -0.02215678, 0.08292903, 0.039246134, 0.05025304, 0.0093421135, -0.031195085, 0.040673606, 0.050633844, -0.040530924, 0.057355154, -0.06647939, 0.016544977, 0.0027414537, -0.025781687, -0.021984955, -0.08593256, 0.07497184, -0.01944906, -0.0071073724, -0.052107796, 0.07111148, -0.029540297, -0.015222887, -0.110427424, -0.03706786, -0.019260092, -0.04361504, -0.0032662323, -0.0024515754, -0.049320962, -0.06746089, -0.02809249, -0.06789855, -0.0060918494, 0.0033360873, -0.026060786, 0.058003116, -0.015383474, -0.03439407, 0.03407821, 0.040493023, -0.11097103, 0.025653271, 0.18678638, -0.047791127, 0.007143844, 0.009395271, -0.011940998, 0.021611772, 0.02634136, 0.08358824, -0.094512105, 0.034739457, 0.046426263, 0.10480719, 0.031097513, 0.14039886, 0.017271241, -0.053809784, 0.032212235, -0.06293511, -0.02893967, -0.02033052, 0.008399191, -0.0645749, 0.11447877, 2.2355974e-33, -0.0820944, 0.05548136, -0.04309879, 0.07550884, 0.02111695, 0.02536701, -0.0330656, -0.020961313, 0.08418383, 0.07006295, -0.03910304, -0.004786398, 0.036816426, -0.00041819175, 0.04265957, -0.088458166, 0.07373147, -0.018982252, 0.072890624, 0.0048585064, -0.0023924655, 0.039066788, 0.056819644, -0.05499771, 0.031141436, 0.046660747, -0.054330196, -0.047602385, -0.08604545, 0.11060021, 0.023165442, -0.032096744, -0.0040301336, 0.03500654, -0.030350499, 0.012768756, -0.028815227, 0.09188549, 0.0049884743, 0.00076851354, 0.06685706, -0.05867073, 0.1074391, 0.040808387, 0.007552951, -0.089992374, -0.057631098, -0.03126913, 0.03129438, -0.06081135, -0.058753576, -0.0021250446, -0.019871494, 0.052945636, -0.075339705, 0.06488972, 0.060905747, 0.0023621898, 0.04578567, 0.007731413, -0.014058804, 0.03477679, 0.009204652, 0.05108054, -0.024392698, -0.008773278, 0.053738516, -0.11270772, -0.004650724, -0.026625045, -0.03844157, -0.022281526, 0.04401636, -0.020845134, 0.008961446, 0.055555806, 0.023265487, 0.016881254, -0.014310777, 0.019392075, -0.047209106, -0.037549723, 0.08710021, 0.05857731, -0.05343594, -0.08275873, 0.003557974, -0.06429083, -0.000453416, -0.0033906528, -0.03663059, 0.05896903, 0.05342251, -0.03497469, -0.009900141, -1.2542967e-08, -0.0025728943, -0.023903146, -0.07308231, 0.022457233, 0.04511856, -0.0757089, -0.061262358, 0.07614636, -0.060821872, 0.029026113, 0.026404921, 0.00741754, 0.02364449, -0.043172844, 0.019123228, -0.003692343, -0.06269392, -0.06399538, -0.11399719, -0.041684534, -0.013414748, 0.03337516, 0.011895136, -0.012368417, -0.045732394, 0.033789538, 0.11687197, 0.092890985, 0.023774406, 0.05863614, -0.032890055, 0.05919358, 0.016616108, -0.042456307, 0.04821618, -0.052977044, 0.009063765, -0.00730487, -0.031044291, -0.009349478, -0.0030403563, -0.12804116, -0.09009529, -0.010882007, 0.080972604, 0.014454904, -0.12107602, -0.032557912, -0.010117173, -0.06635483, -0.023490667, 0.010329779, 0.06979471, 0.006499256, -0.011852056, -0.060198244, 0.034056015, -0.011847793, 0.06382246, 0.00027481493, 0.045803957, -0.08280878, 0.08453003, -0.06507479]"
21-Dec-14,bacs,hmrc,,1000.0,3548,"[-0.0052491594, 0.04386897, 0.0154508995, -0.06774613, -0.013538009, -0.035707068, 0.08170384, 0.012033726, 0.027046742, -0.032492425, 0.00735984, -0.029934715, 0.04844812, 0.06264972, -0.0012563891, 9.565305e-05, 0.0023523802, -0.013355474, -0.013663266, 0.032294955, -0.026827805, 0.074584395, -0.030032922, 0.02974332, -0.083051644, 0.061323274, -0.009938636, 0.009637198, -0.062316954, -0.077297434, 0.006047734, -0.033893798, 0.023939494, 0.020492211, -0.013042471, 0.03679819, 0.08536393, 0.06176735, -0.057785, -0.08436903, -0.02550395, -0.123933144, -0.027217124, 0.050347753, 0.016711542, 0.1057134, 0.043581728, -0.018498978, -0.016861616, 0.036246598, -0.02785212, -0.04359317, 0.006609159, 0.026211103, -0.02075472, -0.0652899, -0.056129336, 0.009088198, 0.06266778, -0.091543026, -0.07376702, 0.04579847, -0.01508506, 0.059402563, 0.05520216, -0.0022322938, 0.010710264, -0.015797194, -0.048911426, -0.028831793, -0.025204137, -0.094293214, -0.0024602697, -0.0106322635, 0.034966953, 0.03679051, -0.0059389453, -0.07783628, 0.040444344, -0.024659729, 0.009222018, 0.084587075, -0.068671204, 0.113422595, 0.037681296, -0.039772578, -0.021058165, 0.010956884, -0.053692356, 0.024167433, 0.023631288, -0.03259571, 0.07453887, 0.025941951, -0.014926663, -0.02022596, -0.008477314, 0.06311679, -0.023386959, 0.14143188, 0.0037655476, 0.0508244, -0.07276974, 0.03280618, 0.04479127, -0.016031124, -0.03529698, 0.00067628734, 0.088937394, -0.032246266, -0.036820825, 0.018466916, -0.15758401, -0.06663431, -0.060630515, 0.07127197, -0.03197217, 0.06291492, 0.016519392, -0.050031472, 0.004239171, -0.004028551, -0.030845998, -0.03356165, -0.04050795, -0.019347511, 0.064159125, -4.2188797e-33, -0.043177385, -0.031322878, 0.06351317, -0.039103363, 0.036225673, -0.08157458, 0.08349416, -0.011587708, 0.016699702, 0.042954937, 0.014424352, 0.050172087, -0.022129087, -0.0026811229, -0.045945495, -0.04479556, 0.03449498, 0.06690252, 0.019304719, 0.05069024, -0.00079778244, 0.050829116, 0.058778226, 0.04438168, -0.0011874366, 0.03833016, 0.028742963, -0.04411643, 0.19130576, 0.054927956, 0.007875862, 0.018281259, 0.039415058, -0.01450879, -0.05414875, 0.062000386, -0.027149906, -0.014183954, -0.023817156, -0.03638307, -0.07476919, -0.015049284, -0.03913363, -0.009272908, -0.025043132, -0.032441363, -0.0072272164, -0.020859288, -0.04488818, 0.09351873, -0.025756337, -0.0067656394, -0.058502387, -0.04528984, 0.020271007, -0.10454213, -0.03410908, 0.08485016, -0.051458634, -0.070769615, 0.015386379, 0.070644125, 0.029132828, 0.07883944, -0.00822645, -0.08194547, -0.03671629, -0.049798146, 0.00531435, -0.019409835, -0.06935063, 0.13070056, 0.07301733, 0.023579359, -0.029577583, -0.01980614, -0.058016542, 0.052795142, 0.021967003, 0.007915128, 0.005734686, 0.07968408, -0.011933539, 0.07643762, 0.10799774, 0.0023254596, 0.00094953016, 0.03571579, -0.0923976, -0.014265541, -0.13185863, -0.012823434, 0.06323363, 0.058295093, -0.009616845, 2.456633e-33, -0.036863644, -0.10722813, 0.07276166, 0.04630593, -5.2644227e-05, -0.0096252225, -0.0013888235, 0.0173214, -0.08778032, 0.11220173, 0.012765234, -0.01703484, 0.04531713, 0.040711846, -0.0025486294, -0.041927774, -0.0005764375, 0.026026238, 0.0077654393, 0.08194291, -0.008507317, -0.0040337667, 0.0864843, 0.045668546, -0.0081918165, 0.046276085, 0.04805488, -0.008414478, 0.028552035, -0.054497566, -0.028993487, 0.06499943, -0.051115837, -0.053229462, -0.019175496, 0.011331659, -0.10128172, 0.05653627, -0.029998831, -0.017951524, 0.028872631, -0.075715296, 0.0011155698, 0.063436486, 0.014086414, -0.01525947, -0.0030017036, -0.012521177, 0.15976869, 0.12852408, 0.027727809, 0.056942783, 0.025068171, -0.03517866, -0.003041795, 0.013400368, -0.10738889, -0.032332737, 0.045929186, -0.08244152, -0.034975868, 0.0142277945, -0.046634194, 0.07159038, -0.02370579, 0.036358997, -0.04477785, -0.0042768572, -0.0034018066, 0.015616002, 0.01780548, -0.031717543, -0.00426198, -0.08722539, 0.07902977, -0.07998037, -0.013177317, -0.056031764, -0.012919013, 0.032875825, -0.0004038135, -0.05405255, -0.0030778695, 0.055513445, 0.012946827, -0.11982352, 0.07792044, -0.040647212, -0.06307181, 0.034993444, -0.013721135, 0.058356285, -0.00819398, -0.0026810153, -0.06223253, -1.2463226e-08, 0.029384563, -0.06516976, 0.05605161, 0.005123708, -0.0036881245, -0.0026089023, -0.018225633, 0.0033598747, -0.022118894, 0.047331378, 0.076197475, 0.03289291, -0.0019864172, -0.061236445, 0.008709523, -0.05468247, 0.03397749, 0.0036865126, -0.0002992451, -0.005912681, -0.0453066, -0.025609588, 0.08951512, 0.0580371, -0.008955278, 0.040732652, 0.052933037, -0.06361292, -0.016552428, -0.020399917, 0.06472057, 0.052756347, -0.020071927, -0.046131648, -0.07102641, -0.073639706, -0.02501841, 0.022151785, 0.023866033, -0.02216811, -0.026670134, -0.01578214, -0.027831918, 0.023954248, -0.02003179, -0.068106346, -0.062130235, 0.026350234, -0.08347956, -0.092568435, -0.006702294, -0.018166559, 0.05567015, -0.0042048465, 0.044378266, 0.08080448, 0.14313214, -0.045711786, -0.041878726, 0.035405397, 0.08169006, -0.020146552, 0.040317133, 0.0021186778]"
21-Dec-14,dd,dvla,,280.0,2548,"[-0.10235173, 0.0028732938, -0.04909218, -0.029164927, -0.08625026, -0.06936094, 0.049982514, 0.0103646815, 0.041760154, -0.030902436, -0.032596573, -0.01566361, -0.07401865, 0.046654087, 0.016316712, -0.029838596, 0.021844456, -0.049979303, -0.08224717, 0.0032431807, -0.0064434535, 0.053655334, -0.009421026, -0.0018781992, 0.0040110573, 0.053557552, -0.01350793, 0.10208347, 0.042482458, -0.12958813, 0.027351527, 0.0049952567, 0.04665844, -0.0067598894, 0.021207532, 0.0064382353, -0.0617041, 0.06106105, -0.023069803, -0.01883705, -0.04063097, 0.014858288, -0.00912948, 0.0069519747, -0.0032010693, -0.0027579232, -0.07161364, 0.05398355, -0.0015189379, 0.028668, 0.031098083, -0.06249312, 0.04476491, 0.016741533, 0.012537651, -0.021932375, 0.015339669, 0.023434315, 0.029056977, -0.04098117, 0.045751628, 0.054333366, -0.05660967, 0.05783505, -0.031211602, -0.03757329, 0.0568816, -0.00827377, -0.008407132, -0.029768173, -0.056953195, -0.0030469391, -0.015528347, 0.059598904, 0.008397711, -0.041644283, 0.052743535, -0.13172977, 0.123307385, -0.02460995, 0.09046626, 0.029709117, -0.10310527, 0.082929276, -0.021925392, 0.045075815, -0.04593434, -0.06706223, 0.046665438, -0.041916274, -0.049075775, -0.019893248, 0.021352014, -0.02763323, -0.010025557, 0.029612696, 0.0109542515, -0.070200905, 0.002173343, 0.16297884, 0.046194922, -0.02604631, -0.09438174, 0.0031463702, -0.038618136, -0.008126172, 0.029477306, 0.030019931, -0.05448609, 0.0077514877, 0.0019561464, 0.05501873, -0.006321165, 0.023661671, -0.04976693, 0.02078738, 0.02219687, 0.017444689, 0.09529965, -0.14997378, -0.025329506, -0.052599814, 0.042637475, -0.0031055904, 0.005601696, -0.097310476, -0.014363395, -1.1835459e-33, 0.005738326, -0.049293425, -0.01763474, 0.042714655, 0.046387576, -0.026392335, 0.04346964, -0.036584534, -0.117545635, -0.031277016, -0.095985115, 0.008569285, -0.0006400387, 0.025641058, 0.010107412, 0.06257781, 0.043803938, 0.04201758, -0.06717663, -0.0015634858, 0.08181378, 0.04629071, 0.051941585, 0.061937552, 0.0069518485, 0.040353335, -0.024611438, 0.03903181, 0.073546, 0.04103096, -0.0030492807, -0.038463555, 0.06330998, 0.051692132, -0.014215371, 0.041324213, -0.07093379, -0.048585664, 0.029240586, -0.0025996896, 0.041504115, 0.008409159, -0.057434916, -0.02603199, -0.065158315, 0.09248286, 0.04088814, 0.01255667, -0.10680045, 0.0205235, -0.011465109, -0.0119726285, -0.050543364, -0.116608456, -0.060869344, 0.015645925, 0.029483583, 0.022617232, 0.050747976, 0.054853875, -0.053936664, 0.0837441, -0.027055606, -0.028523376, 0.020753618, -0.12253359, 0.041017707, -0.033203613, 0.010299571, -0.112963684, 0.010673684, 0.03239765, 0.05899536, -0.026510475, 0.05080635, -0.018233746, -0.013274473, 0.045915972, 0.018333703, -0.046459045, -0.043701407, 0.025048332, 0.007310246, 0.04931256, 0.08755572, 0.029139552, -0.0047437116, -0.06348569, -0.085920595, 0.0070784404, -0.10540025, -0.032006558, 0.10294961, -0.0052717193, 0.06511, 2.0521833e-34, -0.09301654, 0.010323411, 0.012653045, 0.06431095, 0.08296671, -0.013064021, 0.007172475, 0.03879194, 0.05311297, 0.016873894, 0.05432392, -0.017976407, -0.022714755, 0.075359166, -0.010169913, 0.06639543, 0.07209048, -0.031204524, -0.06942573, -0.016810307, 0.001973837, 0.04013817, -0.02665439, 0.016622016, 0.003698594, -0.056824643, 0.09787072, 0.058095824, -0.076245464, 0.009752955, 0.032386485, 0.0014916306, -0.0019233354, 0.042473365, -0.0144055355, 0.010221617, 0.046160344, -0.016638856, -0.03879235, 0.017071966, 0.024646064, -0.022476265, -0.041901376, 0.038841557, -0.011304401, 0.0369294, -0.0039406926, 0.037640546, 0.07485146, 0.067781456, -0.026129471, -0.04339558, 0.017309854, 0.11334871, 0.051479172, 0.02127868, 0.06760451, 0.08645869, -0.0114199, 0.037346657, 0.0027706025, 0.0015647868, -0.022997107, 0.048250847, 0.02234964, 0.028375387, -0.04473845, -0.04906646, -0.03154517, -0.026584832, 0.06513456, -0.021874301, -0.09301892, -0.076061636, -0.12743306, -0.120194204, -0.094931714, -0.008760638, 0.059035044, -0.010304743, -0.07724789, -0.10381656, -0.02383762, 0.09427352, 0.053101778, -0.0020901444, 0.035929915, -0.027000306, -0.020475226, 0.077630155, -0.0074346764, 0.03279323, 0.048865076, -0.009982711, -0.0046321778, -1.4706626e-08, 0.0041992483, 0.03477318, -0.10858541, 0.016638756, 0.057634674, -0.003954298, -0.03200361, 0.04494805, 0.066831835, 0.0999371, 0.050079767, 0.001109549, -0.0078996075, -0.03293538, 0.031675342, 0.08706409, -0.006543838, 0.08704956, -0.021334462, -0.00864318, 0.04654207, -0.007886902, -0.011332225, -0.048490386, -0.0071795997, -0.049114686, 0.020084912, 0.024198625, 0.092811316, -0.100172274, -0.027030524, 0.121449605, -0.048384517, -0.07708339, -0.005101319, -0.05063875, 0.0058150124, 0.016493935, 0.034569822, 0.023335917, 0.056468274, -0.010835186, 0.051993232, 0.020980988, -0.08085432, 0.049872655, -0.057627447, -0.023237886, -0.044808928, -0.058259808, -0.046234258, -0.017851193, 0.025828205, 0.061221875, 0.0109394295, 0.03276003, 0.01800416, 0.054590847, -0.0608502, 0.07202238, 0.070991196, 0.02033155, -0.017412756, -0.052628607]"
